name,latitude,longitude,free_bikes,empty_slots,total_bikes
W 100 St & Manhattan Ave,40.795,-73.9645,7,30,37
7 Ave & Central Park South,40.7667405590595,-73.9790689945221,0,0,0
28 St & 41 Ave,40.751047,-73.93797,0,22,22
Frederick Douglass Blvd & W 112 St,40.801694,-73.957145,33,1,34
3 Ave & E 112 St,40.795508,-73.941606,18,5,23
8 Ave & W 31 St,40.7505853470215,-73.9946848154068,61,32,93
Bergen St & Vanderbilt Ave,40.6794388,-73.9680438,16,8,24
Monroe St & Bedford Ave,40.6851443,-73.95380904,18,1,19
35 Ave & 37 St,40.7557327,-73.9236611,10,18,28
Bank St & Hudson St,40.73652889,-74.00618026,23,2,25
Greenwich St & W Houston St,40.728846,-74.008591,65,12,77
Madison St & Clinton St,40.71269042,-73.98776323,31,7,38
Stanton St & Mangin St,40.71782143,-73.97628939,16,3,19
Clinton Ave & Flushing Ave,40.69794,-73.96986848,19,3,22
Rivington St & Ridge St,40.71850211,-73.98329859,17,32,49
E 114 St & 1 Ave,40.7945663,-73.9362541,23,3,26
Columbia St & Lorraine St,40.6747055,-74.0075572,36,0,36
11 Ave & W 41 St,40.76030096,-73.99884222,38,13,51
Riverside Dr & W 104 St,40.8013434,-73.9711457439,43,15,58
Dwight St & Van Dyke St,40.67363551341504,-74.01195555925369,22,1,23
E 97 St & Madison Ave,40.787801,-73.953559,17,21,38
Union St & 4 Ave,40.6772744,-73.98282002,21,5,26
Berkeley Pl & 6 Ave,40.6765304,-73.97846879,35,5,40
Waterbury St & Stagg St,40.71019,-73.93734,3,20,23
3 Ave & Schermerhorn St,40.68683208,-73.9796772,28,6,34
Pike St & E Broadway,40.71406667,-73.99293911,17,14,31
Lafayette St & E 8 St,40.73020660529954,-73.99102628231049,56,29,85
Knickerbocker Ave & Thames St,40.70539,-73.92976,17,2,19
Devoe St & Morgan Ave,40.713811,-73.93515,6,12,18
McKibbin St & Bogart St,40.706237,-73.933871,27,2,29
Central Ave & Flushing Ave,40.702831,-73.9333,14,6,20
Central Ave & Starr Street,40.700003,-73.92834,13,10,23
Knickerbocker Ave & George St,40.704425,-73.92836,20,3,23
Irving Ave & DeKalb Ave,40.7027,-73.92095,22,4,26
Adelphi St & Myrtle Ave,40.69308257,-73.97178913,16,11,27
1 Ave & E 68 St,40.76500525,-73.95818491,12,50,62
1 Ave & E 62 St,40.7612274,-73.96094022,21,23,44
5 Ave & E 78 St,40.77632142182271,-73.96427392959595,27,17,44
Washington Ave & Greene Ave,40.68650065,-73.96563307,16,1,17
Concord St & Bridge St,40.69766564,-73.98476437,16,3,19
Glenwood Ave,40.72755146730012,-74.07106071710587,8,9,17
Jay St & York St,40.701403172577244,-73.98672670125961,10,28,38
E 106 St & Madison Ave,40.7934337,-73.94945003,20,1,21
Smith St & 3 St,40.6787242,-73.99599099,24,1,25
Cathedral Pkwy & Broadway,40.804213,-73.96699104,14,11,25
3 St & Hoyt St,40.6777287,-73.99364123,36,8,44
W 34 St & 11 Ave,40.75594159,-74.0021163,52,24,76
E 33 St & 5 Ave,40.74765947,-73.98490707,6,48,54
E 51 St & Lexington Ave,40.75714758,-73.97207836,2,70,72
2 Ave & E 31 St,40.74290902,-73.97706058,18,38,56
St Johns Pl & Washington Ave,40.6737236,-73.9631611,18,9,27
Underhill Ave & Lincoln Pl,40.6740123,-73.9671457,11,12,23
Union St & Bedford Ave,40.6691783,-73.9554162,13,10,23
34 Ave & 13 St,40.7638753,-73.9364848,19,0,19
Bedford Ave & S 9 St,40.70853074,-73.96408963,10,10,20
E 45 St & 3 Ave,40.75255434,-73.97282625,11,32,43
E 10 St & Avenue A,40.72740794,-73.98142006,13,82,95
3 Ave & E 71 St,40.76873687,-73.96119945,13,29,42
E 81 St & York Ave,40.7728384,-73.94989233,21,21,42
Union Ave & N 12 St,40.71924,-73.95242,36,2,38
Graham Ave & Herbert St,40.71929301,-73.94500379,22,4,26
Hancock St & Bedford Ave,40.68216564,-73.95399026,9,15,24
Macon St & Nostrand Ave,40.6809833854,-73.9500479759,4,19,23
W 21 St & 6 Ave,40.74173969,-73.99415556,28,45,73
Irving Ave & Jefferson St,40.70538,-73.92535,12,7,19
Washington Pl & Broadway,40.72903917,-73.99404649,10,13,23
W 20 St & 7 Ave,40.74238787,-73.99726235,11,27,38
Pike St & Monroe St,40.71173107,-73.99193043,25,0,25
Reade St & Broadway,40.71450451,-74.00562789,5,51,56
Cherry St,40.71219906,-73.97948148,21,12,33
Warren St & Court St,40.686371,-73.99383324,23,7,30
E 98 St & Park Ave,40.78813,-73.95206,13,9,22
E 93 St & 2 Ave,40.782454175279874,-73.9489196240902,64,8,72
W 92 St & Broadway,40.7921,-73.9739,10,12,22
Bayard St & Leonard St,40.71915571696044,-73.94885390996933,28,13,41
Devoe St & Lorimer St,40.71335226222875,-73.9491033554077,11,3,14
Lenox Ave & W 126 St,40.808442,-73.9452087,28,5,33
Jackson St & Leonard St,40.71638031973561,-73.94821286201477,11,5,16
Leonard St & Maujer St,40.7103685423523,-73.94705951213837,19,1,20
31 St & Hoyt Ave N,40.7711528,-73.9170074,30,3,33
Astoria Park S & Shore Blvd,40.7767,-73.927631,18,13,31
St Nicholas Ave & Manhattan Ave,40.809725,-73.953149,27,2,29
Oakland Ave,40.7376037,-74.0524783,16,10,26
Hilltop,40.7311689,-74.0575736,21,4,25
Hamilton Park,40.727595966,-74.044247311,21,3,24
Newport PATH,40.7272235,-74.0337589,16,1,17
Brunswick St,40.7241765,-74.0506564,10,9,19
Broadway & Whipple St,40.7016657,-73.9437303,5,22,27
Willoughby St & Fleet St,40.69196566,-73.9813018,11,48,59
Washington St,40.7242941,-74.0354826,5,10,15
Harborside,40.7192517,-74.034234,13,16,29
31 St & Newtown Ave,40.7675487799971,-73.9209334552288,20,17,37
Frederick Douglass Blvd & W 115 St,40.8038654,-73.9559308,25,8,33
Myrtle Ave & Marcy Ave,40.69539817,-73.94954908,9,14,23
Throop Ave & Myrtle Ave,40.69622937,-73.94371094,8,11,19
Bank St & Washington St,40.7361967,-74.00859207,11,14,25
Union Ave & Wallabout St,40.70029511,-73.95032283,20,9,29
Lorimer St & Broadway,40.70411791,-73.94818595,26,1,27
Coffey St & Conover St,40.677236,-74.015665,32,0,32
Humboldt St & Varet St,40.7031724,-73.940636,28,7,35
Pioneer St & Richards St,40.6777748,-74.0094613,6,17,23
Van Brunt St & Wolcott St,40.6773429,-74.01275056,25,9,34
Pioneer St & Van Brunt St,40.679043,-74.011169,35,3,38
Clinton St & Joralemon St,40.69239502,-73.99337909,32,15,47
W 13 St & 5 Ave,40.735445,-73.99431,17,25,42
47 Ave & Skillman Ave,40.7437524099784,-73.94176483154297,15,4,19
Vernon Blvd & 50 Ave,40.74232744,-73.95411749,9,36,45
Franklin St & Dupont St,40.73564,-73.95866,24,1,25
Milton St & Franklin St,40.72906,-73.95779,29,1,30
Meserole Ave & Manhattan Ave,40.72708584,-73.95299117,22,4,26
31 St & Broadway,40.761584,-73.925921,18,17,35
Crescent St & Broadway,40.7633589,-73.9286471,7,10,17
7 Ave & Park Pl,40.6776147,-73.97324283,8,17,25
Bergen St & Smith St,40.6867443,-73.99063168,11,36,47
Dean St & Hoyt St,40.6864442,-73.98759104,74,2,76
Bond St & Bergen St,40.6849668,-73.98620772,22,4,26
E 16 St & 5 Ave,40.73726186,-73.99238967,30,27,57
10 St & 2 Ave,40.671907,-73.993612,10,8,18
Hoboken Ave at Monmouth St,40.73520838045357,-74.04696375131607,20,12,32
Henry St & Middagh St,40.7003,-73.991581,10,26,36
Allen St & Rivington St,40.72019576,-73.98997825,17,19,36
Market St & Cherry St,40.71076228,-73.99400398,39,1,40
Newton Rd & 44 St,40.7595701,-73.9142678,15,3,18
28 St & 36 Ave,40.757186,-73.932719,6,22,28
Verona Pl & Fulton St,40.6803560840434,-73.9476791024208,13,6,19
37 Ave & 35 St,40.7531106,-73.9279917,13,13,26
Crescent St & 35 Ave,40.7596276,-73.9321455,16,7,23
21 St & 36 Ave,40.7601853,-73.9362726,19,0,19
36 Ave & 10 St,40.7614376,-73.9411265,17,1,18
Monroe St & Tompkins Ave,40.686203,-73.944694,15,2,17
Franklin Ave & St Marks Ave,40.6758324,-73.9561677,11,12,23
Willoughby Ave & Walworth St,40.69331716,-73.95381995,18,0,18
Franklin Ave & Myrtle Ave,40.694546087246025,-73.95801365375519,21,1,22
6 Ave & Canal St,40.72243797,-74.00566443,31,40,71
John St & William St,40.70862144,-74.00722156,23,15,38
Duffield St & Willoughby St,40.69221589,-73.9842844,41,4,45
Lefferts Pl & Franklin Ave,40.680342423,-73.9557689392,2,21,23
St James Pl & Pearl St,40.71117416,-74.00016545,19,5,24
Atlantic Ave & Fort Greene Pl,40.68382604,-73.97632328,49,12,61
Lafayette Ave & St James Pl,40.68851534,-73.9647628,38,1,39
Atlantic Ave & Furman St,40.69165183,-73.9999786,31,3,34
Columbus Ave & W 103 St,40.7969347,-73.9643412291,9,28,37
Butler St & Court St,40.6849894,-73.99440329,33,1,34
Prospect Park West & 8 St,40.66514681533792,-73.97637605667114,21,3,24
Flushing Ave & Vanderbilt Ave,40.697950315695444,-73.97077560424805,12,11,23
North Moore St & Greenwich St,40.72019521437465,-74.0103006362915,7,21,28
Montgomery St & Franklin Ave,40.666439306870814,-73.9605563879013,11,6,17
36 Ave & 31 St,40.75651272984955,-73.92957486212252,18,5,23
Leonard St & Nassau Ave,40.7239567849954,-73.94984364509583,13,19,32
Myrtle Ave & St Edwards St,40.69327018,-73.97703874,49,4,53
Willoughby Ave & Hall St,40.69196035,-73.96536851,22,23,45
Perry St & Bleecker St,40.73535398,-74.00483091,66,8,74
DeKalb Ave & S Portland Ave,40.68981035,-73.97493121,18,4,22
E 72 St & York Ave,40.76663814,-73.95348296,9,25,34
W 67 St & Broadway,40.77492513,-73.98266566,25,3,28
Harrison St & Hudson St,40.71870987,-74.0090009,8,30,38
Laight St & Hudson St,40.72185379,-74.00771779,23,60,83
E 106 St & 1 Ave,40.7892529,-73.93956237,20,3,23
Richards St & Delavan St,40.6794327,-74.00785041,18,1,19
Commerce St & Van Brunt St,40.6812117,-74.00860912,15,3,18
Henry St & W 9 St,40.6763744,-74.00324957,17,1,18
Columbia St & W 9 St,40.6769993,-74.00647134,18,2,20
Court St & Nelson St,40.6763947,-73.99869893,26,6,32
Clinton St & 4 Place,40.6783563,-74.00014502,14,11,25
7 St & 3 Ave,40.67260298150126,-73.98983001708984,13,7,20
Smith St & 9 St,40.6746957,-73.99785768,8,12,20
W 43 St & 10 Ave,40.76009437,-73.99461843,29,65,94
12 Ave & W 40 St,40.76087502,-74.00277668,34,34,68
11 Ave & W 27 St,40.751396,-74.005226,24,15,39
21 St & 31 Dr,40.7659,-73.930819,11,9,20
Carroll St & Franklin Ave,40.6679411,-73.9588,9,9,18
Sullivan Pl & Bedford Ave,40.6642406,-73.9574686,12,6,18
35 St & Broadway,40.760339,-73.9222427,11,7,18
W 22 St & 8 Ave,40.74475148,-73.99915362,5,57,62
E 51 St & 1 Ave,40.75455731,-73.96592976,29,3,32
E 25 St & 1 Ave,40.7381765,-73.97738662,17,14,31
Park Pl & Church St,40.71334184275907,-74.00935515761375,7,47,54
N 11 St & Kent Ave,40.72248188638219,-73.95921930670738,14,11,25
Jackson Square,40.71113,-74.0789,11,7,18
W 64 St & Thelonious Monk Circle,40.77515953434235,-73.98918695747852,30,10,40
Union Ave & Jackson St,40.7160751,-73.952029,15,3,18
Roebling St & N 4 St,40.71469,-73.95739,19,5,24
Metropolitan Ave & Meeker Ave,40.71413311,-73.95234386,26,2,28
Graham Ave & Grand St,40.711863,-73.944024,5,23,28
S 4 St & Rodney St,40.70934,-73.95608,1,20,21
Hope St & Union Ave,40.71167351,-73.95141312,23,1,24
Riverview Park,40.7443187,-74.0439909,13,0,13
19 St & 24 Ave,40.7774552,-73.9225403,11,8,19
23 Ave & 27 St,40.776165,-73.9153175,9,12,21
37 St & 24 Ave,40.7701477,-73.9120938,9,8,17
24 Ave & 29 St,40.7729,-73.916142,31,11,42
W 90 St & Amsterdam Ave,40.79017948095081,-73.97288918495178,22,9,31
W 89 St & Columbus Ave,40.7882213,-73.97041561,30,15,45
Leonard Gordon Park,40.74590996631558,-74.0572714805603,11,3,14
Astor Place,40.71928220070702,-74.07126188278198,7,7,14
Morningside Dr & Amsterdam Ave,40.81028506306003,-73.95736455917358,4,31,35
W 52 St & 6 Ave,40.76132983124814,-73.97982001304626,3,56,59
Bergen Ave,40.722103786686034,-74.07145500183105,8,3,11
E 60 St & York Ave,40.759107,-73.959223,23,4,27
E 84 St & Park Ave,40.77862688,-73.95772073,39,4,43
E 81 St & 3 Ave,40.77573034,-73.9567526,26,16,42
5 Corners Library,40.734961020009514,-74.0595030784607,12,5,17
Dean St & Franklin Ave,40.67759206937376,-73.955637216568,16,5,21
Lincoln Park,40.7246050998869,-74.07840594649315,12,5,17
E 67 St & Park Ave,40.76780080148132,-73.96592080593109,13,26,39
W 42 St & Dyer Ave,40.75898481399634,-73.99379968643188,4,28,32
Lawrence St & Willoughby St,40.69236178,-73.98631746,13,25,38
Cadman Plaza E & Red Cross Pl,40.69991755,-73.98971773,31,8,39
Vesey Pl & River Terrace,40.7153379,-74.01658354,0,56,56
DeKalb Ave & Hudson Ave,40.689888,-73.981013,21,49,70
Watts St & Greenwich St,40.72405549,-74.00965965,31,2,33
Lenox Ave & W 117 St,40.8025566,-73.9490782,14,13,27
W 120 St & Claremont Ave,40.8109494,-73.9634,12,26,38
E 128 St & Madison Ave,40.80756,-73.939182,19,0,19
E 66 St & Madison Ave,40.76800889305947,-73.96845281124115,1,24,25
3 St & Prospect Park West,40.668132,-73.97363831,20,1,21
W 106 St & Amsterdam Ave,40.8008363,-73.9664492472,14,20,34
Amsterdam Ave & W 66 St,40.7746671,-73.98470567,3,14,17
E 102 St & 1 Ave,40.7869946,-73.94164802,18,3,21
Lewis Ave & Kosciuszko St,40.69237074,-73.93705428,9,9,18
Pulaski St & Marcus Garvey Blvd,40.6933982,-73.939877,10,8,18
Kosciuszko St & Nostrand Ave,40.69072549,-73.95133465,6,10,16
Kosciuszko St & Tompkins Ave,40.69128258,-73.9452416,13,5,18
Greene Ave & Throop Ave,40.6894932,-73.942061,14,5,19
Greene Ave & Nostrand Ave,40.6883337,-73.950916,5,17,22
Marcy Ave & Lafayette Ave,40.6900815,-73.947915,19,1,20
Putnam Ave & Throop Ave,40.6851532,-73.94111,10,10,20
Park Ave & Marcus Garvey Blvd,40.698617,-73.941342,15,8,23
Riverside Dr & W 78 St,40.78414472,-73.98362492,29,45,74
Driggs Ave & N 9 St,40.71816969454208,-73.95520135760307,24,22,46
40 Ave & Crescent St,40.753599202005596,-73.93795609474182,1,21,22
Pleasant Ave & E 120 St,40.7974772,-73.9311847,11,2,13
1 Ave & E 110 St,40.7923272,-73.9383,16,7,23
E 115 St & Lexington Ave,40.797911,-73.9423,8,16,24
E 48 St & 3 Ave,40.7546011026,-73.971878855,17,49,66
31 St & Northern Blvd,40.75186951421875,-73.93349289894103,16,19,35
E 2 St & Avenue A,40.72307749068673,-73.98583620786667,22,11,33
21 St & 43 Ave,40.75052534,-73.94594845,16,11,27
Queens Plaza North & Crescent St,40.75110165,-73.94073717,0,36,36
48 Ave & 5 St,40.744363287066875,-73.9558732509613,71,7,78
Jackson Ave & 46 Rd,40.74524768,-73.94733276,9,15,24
44 Dr & Jackson Ave,40.74718234,-73.9432635,18,16,34
46 Ave & 5 St,40.74731,-73.95451,31,6,37
45 Rd & 11 St,40.74708586,-73.94977234,14,7,21
Steinway St & 23 Ave,40.7713937,-73.9077436,12,5,17
E 23 St & 1 Ave,40.736502,-73.97809472,7,19,26
Lenox Ave & W 130 St,40.8107922,-73.9430681,23,1,24
Court St & State St,40.6902375,-73.99203074,21,5,26
5 St & 6 Ave,40.6704836,-73.98208968,9,12,21
7 St & 5 Ave,40.6704922,-73.98541675,22,2,24
Barrow St & Hudson St,40.73172428,-74.00674436,27,16,43
Clinton St & Union St,40.6831164,-73.99785267,21,15,36
Cumberland St & Lafayette Ave,40.68753406,-73.97265183,21,3,24
Barclay St & Church St,40.71291224,-74.01020234,6,28,34
E 6 St & Avenue D,40.72228087,-73.97668709,37,6,43
Forsyth St & Canal St,40.7158155,-73.99422366,21,4,25
Pacific St & Nevins St,40.6853761,-73.98302136,12,4,16
Front St & Gold St,40.70224,-73.982578,31,4,35
Fulton St & Broadway,40.711066,-74.009447,22,26,48
Washington Ave & Park Ave,40.69610226,-73.96751037,51,0,51
Allen St & Stanton St,40.722055,-73.989111,25,22,47
Norfolk St & Broome St,40.7172274,-73.98802084,49,2,51
South St & Gouverneur Ln,40.70355377,-74.00670227,36,5,41
Marin Light Rail,40.71458403535893,-74.04281705617905,0,25,25
Communipaw & Berry Lane,40.71435836870427,-74.06661093235016,5,8,13
Columbus Drive,40.71835519823214,-74.03891444206238,7,7,14
Jersey & 3rd,40.72333158646436,-74.04595255851744,2,12,14
Manila & 1st,40.721650724879986,-74.04288411140442,7,11,18
Jersey & 6th St,40.72528910781132,-74.04557168483734,5,9,14
Monmouth and 6th,40.72568548362901,-74.04879033565521,6,4,10
Dixon Mills,40.721630142638354,-74.04996782541275,5,12,17
Sterling Pl & Bedford Ave,40.672695,-73.954131,4,17,21
W 15 St & 10 Ave,40.742753828659026,-74.00747358798981,31,26,57
Crescent St & 34 Ave,40.76108,-73.930562,25,1,26
Prospect Pl & Underhill Ave,40.6769694,-73.96579,14,8,22
34 Ave & 21 St,40.7628138,-73.9342862,20,1,21
2 Ave & 36 St,40.65708866668485,-74.00870203971863,19,24,43
35 St & 34 Ave,40.7580583,-73.9242751,9,16,25
34 Ave & 38 St,40.756913,-73.921631,10,21,31
Vernon Blvd & 10 St,40.7671863,-73.9373554,40,1,41
Washington Pl & 6 Ave,40.73224119,-74.00026394,28,41,69
Lafayette Ave & Classon Ave,40.68900443,-73.96023854,21,6,27
Douglass St & 4 Ave,40.6792788,-73.98154004,45,3,48
William St & Pine St,40.70717936,-74.00887308,24,32,56
Degraw St & Hoyt St,40.681990442707026,-73.99079024791718,16,8,24
2 Ave & E 96 St,40.7839636,-73.9471673,37,7,44
Centre St & Worth St,40.71494807,-74.00234482,8,65,73
Centre St & Chambers St,40.71273266,-74.0046073,27,28,55
W 26 St & 10 Ave,40.749717753,-74.002950346,7,40,47
6 Ave & 12 St,40.6663181,-73.9854617,18,8,26
1 Ave & E 94 St,40.7817212,-73.94594,32,6,38
Henry St & Degraw St,40.6847514,-73.99917254,21,1,22
10 St & 5 Ave,40.6686273,-73.98700053,20,2,22
14 St & 5 Ave,40.666287,-73.98895053,13,7,20
21 St & Queens Plaza North,40.75325964,-73.94335788,16,18,34
Vernon Blvd & 47 Rd,40.7449067,-73.9534573,23,5,28
30 Ave & 21 St,40.7703743,-73.9286078,6,8,14
Center Blvd & 48 Ave,40.745038,-73.957539,21,5,26
Crescent St & 30 Ave,40.768692,-73.9249574,7,15,22
Steinway St & 28 Ave,40.7656251,-73.9136695,13,12,25
28 Ave & 35 St,40.7671,-73.9169858,15,12,27
27 St & Hunter St,40.7485,-73.941275,19,8,27
Newtown Ave & 23 St,40.7713615,-73.9246145,18,9,27
DeKalb Ave & Franklin Ave,40.69064807082943,-73.95746178925037,15,1,16
Stagg St & Morgan Ave,40.710681,-73.93372,14,9,23
White St & Moore St,40.704508,-73.9351,18,2,20
Columbia St & Kane St,40.68763155,-74.0016256,18,2,20
DeKalb Ave & Vanderbilt Ave,40.68940747,-73.96885458,15,8,23
South St & Whitehall St,40.70122128,-74.01234218,41,13,54
MacDougal St & Washington Sq,40.73226398,-73.99852205,18,10,28
Amsterdam Ave & W 73 St,40.77966809007312,-73.98093044757842,35,18,53
Columbus Ave & W 72 St,40.7770575,-73.97898475,29,36,65
Mott St & Prince St,40.72317958,-73.99480012,31,7,38
Lispenard St & Broadway,40.71939226,-74.00247214,53,9,62
W 11 St & 6 Ave,40.73532427,-73.99800419,25,16,41
W 76 St & Columbus Ave,40.7801839724239,-73.97728532552719,37,22,59
5 Ave & 3 St,40.6728155,-73.98352355,14,11,25
E 82 St & East End Ave,40.7724607,-73.9468208,12,17,29
Carroll St & 5 Ave,40.6751622,-73.9814832,22,4,26
3 St & 7 Ave,40.6703837,-73.97839676,23,2,25
West End Ave & W 107 St,40.8021174,-73.9681805305,11,18,29
5 Ave & E 103 St,40.7922553,-73.95249933,8,23,31
E 102 St & Park Ave,40.7904828,-73.95033068,33,0,33
6 Ave & W 33 St,40.74901271,-73.98848395,39,15,54
Broadway & W 51 St,40.76228826,-73.98336183,5,71,76
FDR Drive & E 35 St,40.744219,-73.97121214,74,40,114
W 25 St & 6 Ave,40.74395411,-73.99144871,16,28,44
E 47 St & 2 Ave,40.75323098,-73.97032517,59,35,94
2 Ave & E 72 St,40.7687620293096,-73.95840793848038,17,33,50
W 104 St & Amsterdam Ave,40.799041392882984,-73.96649479866028,38,5,43
Grand St,40.71517767732029,-74.03768330812454,1,16,17
E 77 St & 3 Ave,40.77314236,-73.95856158,6,40,46
E 27 St & 1 Ave,40.739445,-73.976806,28,56,84
Frederick Douglass Blvd & W 129 St,40.8125511,-73.9492286,18,7,25
Crescent St & Ditmars Blvd,40.7787185,-73.9145645,6,12,18
St. Nicholas Ave & W 126 St,40.8114323,-73.9518776,29,0,29
Frederick Douglass Blvd & W 117 St,40.805159,-73.954692,17,14,31
W 116 St & Broadway,40.8082,-73.9641,18,22,40
W 116 St & Amsterdam Ave,40.8067581,-73.9607082,5,24,29
W 110 St & Amsterdam Ave,40.802692,-73.96295,29,16,45
Lenox Ave & W 111 St,40.7987859,-73.9523,23,11,34
Paulus Hook,40.7141454,-74.0335519,5,9,14
City Hall,40.7177325,-74.043845,6,14,20
Warren St,40.7211236,-74.03805095,16,4,20
Graham Ave & Withers St,40.7169811,-73.94485918,13,4,17
E 4 St & 2 Ave,40.7262807,-73.98978041,55,21,76
Carroll St & Washington Ave,40.6686744,-73.9618148,13,10,23
Lexington Ave & E 120 St,40.8013066,-73.9398167,26,2,28
Pacific St & Classon Ave,40.6791944,-73.9587903,12,8,20
Broadway & Moylan Pl,40.8143256,-73.9590255,38,2,40
Morningside Ave & W 123 St,40.81,-73.9551508,27,4,31
3 Ave & E 62 St,40.76312584,-73.96526895,8,37,45
Baldwin at Montgomery,40.7236589,-74.0641943,1,10,11
47 Ave & 31 St,40.743,-73.93561,15,12,27
5 Ave & E 72 St,40.77282817,-73.96685276,0,0,0
Bayard St & Baxter St,40.71602118,-73.99974372,27,13,40
Emerson Pl & Myrtle Ave,40.69363137,-73.96223558,41,21,62
S Portland Ave & Hanson Pl,40.68539567,-73.97431458,24,2,26
Clinton St & Grand St,40.71559509,-73.9870295,53,15,68
Christopher St & Greenwich St,40.73291553,-74.00711384,41,23,64
Columbia Heights & Cranberry St,40.70037867,-73.99548059,5,29,34
W 16 St & The High Line,40.74334935,-74.00681753,4,53,57
W 129 St & Convent Ave,40.814394437915816,-73.95324736833572,9,19,28
George St & Wilson Ave,40.702997,-73.92997,16,3,19
Cambridge Pl & Gates Ave,40.68488,-73.96304,9,8,17
W 106 St & Central Park West,40.7981856,-73.9605909006,43,13,56
Clinton St & Centre St,40.67434,-74.00194698,4,16,20
3 Ave & E 100 St,40.7877214,-73.94728331,20,4,24
Kingston Ave & Herkimer St,40.67890679,-73.94142771,22,2,24
Degraw St & Smith St,40.6829151,-73.99318208,23,3,26
Lewis Ave & Decatur St,40.6814598,-73.934903,13,5,18
Fulton St & Utica Ave,40.6794268,-73.9298911,0,18,18
Albany Ave & Fulton St,40.6800105,-73.938475,15,12,27
Halsey St & Tompkins Ave,40.6823687,-73.944118,18,3,21
Monroe St & Classon Ave,40.6845683,-73.95881081,12,4,16
Adam Clayton Powell Blvd & W 118 St,40.804372,-73.951475,19,5,24
Broadway & E 14 St,40.73454567,-73.99074142,12,79,91
Willoughby Ave & Wyckoff Ave,40.705614,-73.92153,11,10,21
Cedar St & Myrtle Ave,40.697842,-73.926241,19,8,27
3 Ave & Carroll St,40.677027,-73.9865,17,0,17
Wyckoff Av & Jefferson St,40.707165,-73.923711,16,11,27
Bushwick Ave & McKibbin St,40.705517,-73.93936,13,8,21
Bushwick Ave & Stagg St,40.709897,-73.94008,9,12,21
White St & Johnson Ave,40.707174,-73.93581,13,10,23
Montgomery St,40.71942,-74.05099,7,5,12
E 75 St & 3 Ave,40.77112927,-73.95772297,15,24,39
Washington Park,40.6917823,-73.9737299,10,9,19
Johnson St & Gold St,40.69474881,-73.98362464,33,7,40
Broad St & Bridge St,40.70365182,-74.01167797,11,35,46
Broadway & W 36 St,40.75097711,-73.98765428,41,24,65
Stanton St & Chrystie St,40.72229346,-73.99147535,34,13,47
35 Ave & 10 St,40.76315481910373,-73.93985509872437,25,0,25
Broadway & W 25 St,40.74286877312112,-73.98918628692627,6,87,93
Journal Square,40.73367,-74.0625,0,17,17
1 Ave & E 30 St,40.74144387,-73.97536082,5,32,37
S 5 Pl & S 5 St,40.710451,-73.960876,33,8,41
Forsyth St & Broome St,40.71893904,-73.99266288,4,59,63
11 Ave & W 59 St,40.77149671054441,-73.99046033620834,17,0,17
34 St & 35 Ave,40.7569332,-73.9262231,5,13,18
Metropolitan Ave & Bedford Ave,40.71534825,-73.96024116,47,6,53
Riverside Dr & W 72 St,40.78057799010334,-73.98562431335449,29,10,39
21 St & 38 Ave,40.7576314,-73.9391224,13,3,16
Clermont Ave & Lafayette Ave,40.68764484,-73.96968902,20,26,46
W 59 St & 10 Ave,40.770513,-73.988038,92,6,98
Bus Slip & State St,40.701907,-74.013942,55,9,64
West St & Chambers St,40.71754834,-74.01322069,71,40,111
St James Pl & Oliver St,40.71307916,-73.99851193,30,17,47
W 70 St & Amsterdam Ave,40.77748046,-73.98288594,28,11,39
E 2 St & Avenue B,40.72217444,-73.98368779,53,28,81
Avenue D & E 3 St,40.72082834,-73.97793172,38,14,52
Mercer St & Spring St,40.72362738,-73.99949601,32,32,64
Canal St & Rutgers St,40.71427487,-73.98990025,34,9,43
Cooper Square & Astor Pl,40.72951496224949,-73.99075269699097,66,19,85
Morris Canal,40.7124188237569,-74.03852552175522,4,9,13
Brunswick & 6th,40.72601172964625,-74.05038893222809,14,0,14
Lafayette Park,40.71346382669195,-74.06285852193832,8,6,14
Lenox Ave & W 115 St,40.8011939,-73.9500739,16,15,31
E 16 St & Irving Pl,40.735367055605394,-73.98797392845154,11,64,75
Murray St & Greenwich St,40.714851505262516,-74.01122331619263,7,40,47
E 115 St & Madison Ave,40.7989445,-73.944846,21,9,30
E 118 St & Madison Ave,40.8014866,-73.9442507,27,0,27
Lexington Ave & E 111 St,40.7954121,-73.9441232,27,2,29
Madison Ave & E 120 St,40.80295,-73.942954,26,3,29
E 123 St & Lexington Ave,40.8029263,-73.9379,22,5,27
Lexington Ave & E 127 St,40.805726,-73.936322,14,7,21
Park Ave & E 124 St,40.8045555,-73.9396861,19,14,33
Broadway & 12 St,40.7668,-73.9347774,27,3,30
W 100 St & Broadway,40.7973721,-73.97041192,33,5,38
Adam Clayton Powell Blvd & W 123 St,40.8078316,-73.949373,22,8,30
Sigourney St & Columbia St,40.67267243410948,-74.0087952464819,18,1,19
Pershing Field,40.742677141,-74.051788633,5,11,16
Newark Ave,40.72152515,-74.046304543,1,18,19
Christ Hospital,40.734785818,-74.050443636,9,12,21
Van Vorst Park,40.71848892,-74.047726625,1,21,22
Garfield Pl & 8 Ave,40.6711978,-73.97484126,17,5,22
Franklin St & W Broadway,40.71911552,-74.00666661,7,21,28
31 Ave & 34 St,40.763154,-73.920827,13,9,22
31 Ave & 14 St,40.7682,-73.9322662,19,0,19
49 Ave & 21 St,40.74252,-73.948852,4,16,20
31 Ave & Crescent St,40.7658346,-73.9265474,11,9,20
Vernon Blvd & 31 Ave,40.7692475,-73.9354504,16,3,19
5 St & 51 Ave,40.7423737,-73.9566,9,11,20
McKibbin St & Manhattan Ave,40.70510918,-73.94407279,15,4,19
Boerum St & Broadway,40.70538077,-73.94976519,9,5,14
Leonard St & Boerum St,40.70583339,-73.94644578,17,6,23
Greene Av & Myrtle Av,40.698568,-73.918877,23,6,29
Montrose Ave & Bushwick Ave,40.70767788,-73.94016171,18,22,40
Division Ave & Marcy Ave,40.70708701,-73.95796783,19,13,32
Scholes St & Manhattan Ave,40.70870368,-73.9448625,20,14,34
Stagg St & Union Ave,40.70877084,-73.95095259,18,14,32
Broadway & Roebling St,40.70924826276157,-73.96063148975372,3,23,26
W 84 St & Columbus Ave,40.78499979,-73.97283406,13,17,30
Riverside Blvd & W 67 St,40.777507027547976,-73.98888587951659,66,11,77
W 20 St & 8 Ave,40.74345335,-74.00004031,26,57,83
Carroll St & Bond St,40.6786115,-73.99037292,22,1,23
E 65 St & 2 Ave,40.76471851944339,-73.96222069859505,23,8,31
Central Park North & Adam Clayton Powell Blvd,40.799484,-73.955613,31,2,33
3 St & 3 Ave,40.6750705,-73.98775226,71,5,76
Grand Ave & Bergen St,40.678045,-73.962408,13,11,24
Cleveland Pl & Spring St,40.722103786686034,-73.99724900722504,25,5,30
E 2 St & Avenue C,40.7208736,-73.98085795,60,23,83
Fulton St & Irving Pl,40.68186,-73.959432,17,13,30
Henry St & Atlantic Ave,40.69089272,-73.99612349,12,8,20
E 97 St & 3 Ave,40.7859201,-73.94860294,26,3,29
10 St & 7 Ave,40.6662078,-73.98199886,21,2,23
Stanton St & Norfolk St,40.720747,-73.986274,22,23,45
6 Ave & 9 St,40.668127,-73.98377641,13,8,21
Nassau Ave & Russell St,40.72557,-73.94434,32,16,48
Banker St & Meserole Ave,40.72606,-73.95621,26,5,31
Rivington St & Chrystie St,40.72110063,-73.9919254,45,15,60
N 15 St & Wythe Ave,40.724055,-73.955736,49,4,53
McGinley Square,40.7253399253558,-74.06762212514877,11,8,19
Liberty Light Rail,40.7112423,-74.0557013,21,1,22
Union St,40.7182113,-74.0836394,1,15,16
10 Ave & W 28 St,40.75066386,-74.00176802,27,37,64
W 15 St & 7 Ave,40.73935542,-73.99931783,36,43,79
S 3 St & Bedford Ave,40.71260486,-73.96264403,12,12,24
Brooklyn Bridge Park - Pier 2,40.698458,-73.997178,25,3,28
Hanson Pl & Ashland Pl,40.68506807308177,-73.97790759801863,25,12,37
Dock 72 Way & Market St,40.69985,-73.97141,15,6,21
Columbia St & Degraw St,40.6859296,-74.00242364,11,7,18
Douglass St & 3 Ave,40.6802133,-73.98432695,21,9,30
2 Ave & E 104 St,40.7892105,-73.94370784,25,3,28
E 106 St & Lexington Ave,40.791976,-73.945993,19,7,26
Wythe Ave & Metropolitan Ave,40.716887,-73.963198,44,11,55
Central Park S & 6 Ave,40.76590936,-73.97634151,17,54,71
W 41 St & 8 Ave,40.75640548,-73.9900262,62,1,63
Pierrepont St & Monroe Pl,40.69535693320225,-73.99344027042389,12,11,23
Catherine St & Monroe St,40.71117444,-73.99682619,32,2,34
Newport Pkwy,40.7287448,-74.0321082,8,2,10
Heights Elevator,40.748715945380226,-74.04044330120087,11,5,16
India St & Manhattan Ave,40.73232194,-73.9550858,34,11,45
Amsterdam Ave & W 125 St,40.813358,-73.956461,32,6,38
Bedford Ave & Montgomery St,40.665816,-73.956934,19,7,26
9 Ave & W 22 St,40.7454973,-74.00197139,30,22,52
43 St & Broadway,40.7577284,-73.9166368,8,15,23
Lafayette St & Jersey St,40.72456089,-73.99565293,41,19,60
E 12 St & 3 Ave,40.73223272,-73.98889957,31,38,69
Clinton Ave & Myrtle Ave,40.693261,-73.968896,21,10,31
27 Ave & 9 St,40.7739825,-73.9309134,20,19,39
E 53 St & Madison Ave,40.7597108,-73.97402311,2,49,51
27 Ave & 3 St,40.77485,-73.9342,11,7,18
E 95 St & 3 Ave,40.7849032,-73.950503,17,9,26
University Pl & E 14 St,40.734814,-73.992085,9,46,55
W 35 St & Dyer Ave,40.754691750226016,-73.99740189313889,3,37,40
Carroll St & 6 Ave,40.6740886,-73.9787282,14,5,19
W 107 St & Columbus Ave,40.7997568,-73.9621128676,20,2,22
Bushwick Ave & Dekalb Ave,40.69502,-73.92825,17,10,27
Beaver St & Fayette St,40.70099,-73.93921,16,12,28
Bushwick Ave & Forrest St,40.70076,-73.93641,16,3,19
Evergreen Ave & Noll St,40.70106,-73.93318,7,18,25
Kent St & McGuinness Blvd,40.73124,-73.95161,17,3,20
Morgan Ave & Maspeth Ave,40.716657,-73.93637,20,5,25
Metropolitan Ave & Vandervoort Ave,40.71429,-73.93323,19,5,24
Calyer St & Jewel St,40.72984,-73.94839,20,15,35
Withers St & Kingsland Ave,40.71773,-73.94051,15,2,17
Harrison Pl & Porter Ave,40.70686,-73.92851,17,3,20
Engert Ave & McGuinness Blvd,40.72158,-73.94546,17,2,19
Jefferson St & Cypress Ave,40.70907,-73.92157,23,2,25
2 Ave & E 122 St,40.8006721,-73.9349,13,6,19
Frost St & Debevoise Ave,40.71882,-73.93948,14,0,14
Myrtle Ave & Linden St,40.69943,-73.91337,8,16,24
Myrtle Ave & Grove St,40.69905,-73.91516,14,6,20
Putnam Ave & Wyckoff Ave,40.69811,-73.90904,12,12,24
Putnam Ave & Knickerbocker Ave,40.69545,-73.91164,25,4,29
Wilson Ave & Troutman St,40.70166,-73.92754,16,10,26
Stewart Ave & Johnson Ave,40.70869,-73.92587,3,14,17
Suydam St & Broadway,40.69544,-73.93223,11,19,30
Wyckoff Av & Stanhope St,40.703545,-73.917775,11,10,21
Metropolitan Ave & Stewart Ave,40.71401,-73.92793,3,17,20
Cedar St & Evergreen Ave,40.69671,-73.92807,8,17,25
Irving Ave & Harman St,40.70108,-73.9179,21,1,22
Menahan St & Wyckoff Ave,40.70113,-73.91422,11,7,18
E 51 St & 2 Ave,40.755293,-73.967641,13,26,39
Dey St,40.737711,-74.066921,7,10,17
Linden St & Knickerbocker Ave,40.69714,-73.91566,15,2,17
Menahan St & Central Ave,40.69543,-73.9196,18,7,25
Central Ave & Himrod St,40.69676,-73.92302,9,16,25
Kingsland Ave & Nassau Ave,40.72577,-73.94173,16,9,25
Irving Ave & Palmetto St,40.698,-73.9127,7,10,17
Bushwick Ave & Harman St,40.69356,-73.92524,9,15,24
Broadway & Kosciuszko St,40.69329,-73.92852,7,20,27
E 116 St & 2 Ave,40.796879,-73.937261,21,10,31
E 85 St & 3 Ave,40.77801203,-73.95407149,24,9,33
Irving Ave & Halsey St,40.69467,-73.90663,4,15,19
Central Ave & Woodbine St,40.69296,-73.91605,15,1,16
Bushwick Ave & Linden St,40.69146,-73.92146,24,3,27
Central Ave & Covert St,40.68929,-73.90951,4,26,30
Central Ave & Decatur St,40.6882,-73.90798,17,7,24
Moffat St & Bushwick,40.68458,-73.90925,10,8,18
Eldert St & Bushwick Ave,40.68652,-73.91321,11,11,22
Halsey St & Broadway,40.68565,-73.91564,5,14,19
Grove St & Broadway,40.69047,-73.923511,15,13,28
E 89 St & 3 Ave,40.7806284,-73.9521667,28,10,38
E 89 St & York Ave,40.7779453,-73.946041,33,1,34
Knickerbocker Ave & Halsey St,40.693,-73.90824,3,16,19
Madison St & Evergreen Ave,40.69122,-73.91693,4,12,16
Halsey St & Evergreen Ave,40.68858,-73.91227,8,12,20
Broadway & Madison St,40.68822,-73.91966,18,6,24
W 15 St & 6 Ave,40.738046142482766,-73.99642959237099,44,28,72
Cliff St & Fulton St,40.70838,-74.00495,33,32,65
Wilson Ave & Moffat St,40.68906,-73.90506,15,15,30
Bushwick Ave & Furman Ave,40.68281,-73.90623,9,21,30
E 56 St & Madison Ave,40.761573,-73.972628,11,15,26
Henry St & Grand St,40.714211,-73.981095,25,8,33
Van Sinderen Ave & Truxton St,40.6786,-73.90369,0,21,21
Broadway & Furman Ave,40.68139,-73.90756,17,11,28
Rockaway Ave & Bainbridge St,40.68319988172761,-73.91166642308235,16,9,25
Center Blvd & 51 Ave,40.743366080270214,-73.95960688591003,19,1,20
Norman St & Wyckoff Ave,40.69517,-73.90311,0,12,12
Forest Ave & Summerfield St,40.69922,-73.89795,14,7,21
Menahan St & Seneca Ave,40.70461,-73.91054,3,13,16
Cypress Ave & Palmetto St,40.701573408737914,-73.90876293182373,1,23,24
38 Ave & 29 St,40.75473,-73.93367,3,15,18
Manhattan Av & Leonard St,40.72084,-73.94844,17,1,18
Morgan Ave & Lombardy St,40.72226,-73.93889,26,3,29
Madison St & Cypress Ave,40.70068,-73.90742,13,3,16
E 81 St & Park Ave,40.77677702,-73.9590097,28,17,45
Stephen St & Seneca Ave,40.6988,-73.9007,2,13,15
Madison St & Seneca Ave,40.70183,-73.90625,3,19,22
Menahan St & Onderdonk Ave,40.70553,-73.9096,6,11,17
E 88 St & Park Ave,40.781410700190015,-73.95595908164978,22,13,35
Stanhope St & Fairview Ave,40.70998,-73.91116,11,5,16
Flushing Ave & Woodward Ave,40.71246,-73.91873,18,1,19
Willoughby Ave & Onderdonk Ave,40.7098,-73.91727,24,3,27
Hancock St & Wyckoff Ave,40.6972,-73.90674,11,7,18
Broadway & Hancock St,40.68663,-73.9168,11,20,31
Madison St & Forest Ave,40.70555,-73.90245,18,7,25
Woodward Ave & Harman St,40.70793,-73.91092,7,11,18
Central Ave & Melrose St,40.70112,-73.93039,1,14,15
W 47 St & 10 Ave,40.76269882,-73.99301222,29,7,36
Adam Clayton Powell Blvd & W 115 St,40.802535,-73.9532423,19,3,22
Madison St & Woodward Ave,40.70408,-73.90408,16,4,20
Fairview Ave & Linden St,40.70694,-73.90632,10,8,18
Greene Ave & Grandview Ave,40.709697,-73.907856,6,9,15
Onderdonk Ave & Dekalb Ave,40.70863,-73.91497,7,9,16
W 42 St & 6 Ave,40.75492,-73.98455,2,50,52
W Broadway & W Houston St,40.726378,-74.000472,30,20,50
Centre St & Seneca Ave,40.69969,-73.9022,9,13,22
W 53 St & 10 Ave,40.76669671,-73.99061728,20,5,25
W 54 St & 9 Ave,40.76584941,-73.98690506,26,15,41
4 Ave & E 12 St,40.732647,-73.99011,11,27,38
Delancey St & Eldridge St,40.719383,-73.991479,30,1,31
Division St & Bowery,40.714193,-73.996732,38,7,45
S 4 St & Wythe Ave,40.71285887,-73.96590294,15,7,22
Willoughby St & Ashland Pl,40.69178,-73.97877,27,2,29
Sands St Gate,40.699569,-73.979827,11,7,18
12 Ave & W 125 St,40.818299,-73.960405,26,6,32
Columbia St & Rivington St,40.71739973,-73.98016555,32,7,39
31 Ave & Steinway St,40.7611488,-73.9170071,16,9,25
24 St & 41 Ave,40.752474,-73.939991,5,13,18
W 30 St & 10 Ave,40.752694,-74.002353,34,20,54
Hoyt St & Warren St,40.6843549,-73.98901629,30,2,32
5 Ave & E 63 St,40.766368,-73.971518,23,26,49
Nassau St & Navy St,40.69839895,-73.98068914,45,11,56
West St & Liberty St,40.711444,-74.014847,17,24,41
E 128 St & 3 Ave,40.805631,-73.934077,17,2,19
2 Ave & E 125 St,40.802554,-73.933509,25,3,28
E 149 St & Morris Ave,40.81734,-73.922962,30,2,32
Lincoln Ave & E 134 St,40.808484,-73.928803,17,0,17
Willis Ave & Bruckner Blvd,40.805701,-73.925177,18,0,18
W 135 St & Lenox Terrace Pl,40.813619,-73.939336,26,0,26
5 Ave & E 135 St,40.812191,-73.937838,11,9,20
Lexington Ave & E 128 St,40.806414,-73.936085,21,3,24
Lincoln Ave & E 138 St,40.810893,-73.927311,18,6,24
E 132 St & Madison Ave,40.810224,-73.937195,14,4,18
5 Ave & W 131 St,40.81014,-73.93973,15,4,19
Adam Clayton Powell Blvd & W 130 St,40.812346,-73.946168,14,6,20
Morris Ave & E 142 St,40.814469,-73.924963,19,2,21
Amsterdam Ave & W 131 St,40.816355,-73.954295,14,4,18
Willis Ave & E 141 St,40.81093,-73.921606,11,6,17
Willis Ave & E 137 St,40.808384,-73.923604,14,7,21
E 53 St & Lexington Ave,40.75828065,-73.97069431,13,43,56
E 138 St & 5 Av,40.81449,-73.936153,13,8,21
Convent Ave & W 135 St,40.818215,-73.950988,4,22,26
Amsterdam Ave & W 136 St,40.819746,-73.951819,5,13,18
E 135 St & St Ann's Ave,40.805089,-73.918889,13,10,23
St. Ann's Av & Bruckner Blvd,40.803399,-73.919763,16,0,16
St Nicholas Ave & W 137 St,40.818477,-73.947568,15,5,20
E 134 St & Walnut Ave,40.800425,-73.911034,11,4,15
Willow Ave & E 133 St,40.800933,-73.913863,14,7,21
E 138 St & Grand Concourse,40.813224,-73.930605,18,2,20
E 138 St & Willow Ave,40.804168,-73.911545,18,0,18
Brook Ave & E 141 St,40.809619,-73.917875,15,3,18
Morris Ave & E 153 St,40.820036,-73.921411,16,2,18
Willis Ave & E 143 St,40.812299,-73.92037,14,4,18
Walnut Ave & E 136 St,40.801657,-73.909513,13,2,15
St Mary's St & Jackson Ave,40.808891,-73.91081,11,8,19
St. Ann's Ave & E 144 St,40.811112,-73.914932,18,4,22
E 144 St & Brook Ave,40.811675,-73.917037,14,1,15
Bradhurst Ave & W 148 St,40.825125,-73.941616,20,0,20
Lenox Ave & W 144 St,40.819783,-73.936521,16,4,20
Riverside Dr & W 138 St,40.823168,-73.955857,26,4,30
W 146 St & Broadway,40.826969,-73.949738,19,9,28
W 145 St & Amsterdam Ave,40.825244,-73.947257,8,15,23
Riverside Dr & W 145 St,40.827305,-73.951989,18,16,34
Melrose Ave & E 150 St,40.816827,-73.917338,9,21,30
E 149 St & Jackson Ave,40.813135,-73.909235,1,20,21
E 149 St & Eagle Ave,40.814046,-73.91186,10,9,19
Greenpoint Ave & Manhattan Ave,40.73026,-73.95394,15,7,22
Lexington Ave & E 29 St,40.74311555376486,-73.98215353488922,10,38,48
Lexington Ave & E 26 St,40.741459,-73.983293,37,41,78
St Nicholas Ave & W 134 St,40.816234,-73.948222,25,0,25
5 Av & W 139 St,40.815484,-73.935856,16,2,18
W 133 St & 12 Ave,40.820003,-73.959089,17,1,18
E 142 St & 3 Ave,40.812735,-73.923697,10,9,19
E 138 St & Cypress Ave,40.805559,-73.914718,6,15,21
LaGuardia Pl & W 3 St,40.72917025,-73.99810231,20,29,49
W Broadway & Spring St,40.72494672359416,-74.00165855884552,39,27,66
Marcus Garvey Blvd & Macon St,40.682601,-73.938037,15,2,17
Lenox Ave & W 133 St,40.81296,-73.941878,21,3,24
Adam Clayton Powell Blvd & W 132 St,40.813539,-73.94521,9,12,21
Brook Ave & E 138 St,40.807408,-73.91924,3,17,20
E 141 St & St Ann's Ave,40.808633,-73.916124,15,3,18
E 141 St & Jackson Ave,40.806896,-73.911837,5,12,17
Edgecombe Ave & W 141 St,40.820681,-73.945144,17,4,21
St. Nicholas Terrace & Convent Ave,40.821294,-73.947868,10,13,23
E 147 St & Bergen Ave,40.814673,-73.91839,15,6,21
Willoughby Ave & Myrtle Ave,40.69757,-73.93098,9,8,17
Motorgate,40.7639089,-73.9477213,28,4,32
Roosevelt Island Tramway,40.757284,-73.9536,33,4,37
Southpoint Park,40.75370225419114,-73.95865201950072,27,8,35
W 148 St & Amsterdam Ave,40.827075,-73.945909,13,9,22
Edgecombe Ave & W 145 St,40.823498,-73.94386,14,15,29
Westchester Ave & Jackson Ave,40.816124,-73.908116,2,22,24
Prospect Ave & E 151 St,40.814232,-73.903927,8,12,20
Wales Ave & E 147 St,40.811314,-73.907729,5,13,18
1 Ave & E 18 St,40.733812191966315,-73.98054420948029,33,18,51
1 Ave & E 16 St,40.73221853,-73.98165557,27,27,54
W 147 St & Adam Clayton Powell Blvd,40.82281,-73.937413,23,2,25
Broadway & W 131 St,40.817555,-73.957163,4,15,19
St Ann's Ave & Westchester Ave,40.815887,-73.911918,5,14,19
West End Ave & W 60 St,40.77237,-73.99005,37,0,37
Southern Blvd & E 142 St,40.807347437082,-73.90809774398804,20,3,23
Adam Clayton Powell Blvd & W 138 St,40.81695971032464,-73.9422959089279,19,3,22
Broadway & W 133 St,40.8190344,-73.956156,5,13,18
Madison Av & E 51 St,40.75863,-73.97513,7,34,41
Adam Clayton Powell Blvd & W 151 St,40.825289,-73.936232,14,3,17
Lenox Ave & W 146 St,40.821111,-73.935971,19,4,23
W 140 St & Riverside Dr,40.824013,-73.954743,17,5,22
Brook Ave & E 148 St,40.814383,-73.915368,15,3,18
Broadway & W 153 St,40.831327,-73.946665,2,16,18
Riverside Dr & W 148 St,40.829114,-73.950426,6,16,22
Edgecombe Ave & W 150 St,40.826881,-73.941427,3,16,19
E 155 St & Courtlandt Ave,40.82057,-73.917579,17,2,19
Melrose Ave & E 154 St,40.819609,-73.916071,14,5,19
St Nicholas Ave & W 150 St,40.827212,-73.942722,2,23,25
Gerard Ave & E 146 St,40.817755,-73.92965,15,2,17
Alexander Ave & E 134 St,40.807466,-73.927107,16,0,16
Amsterdam Ave & W 152 St,40.829523,-73.944279,15,4,19
Cauldwell Ave & E 161 St,40.82188,-73.907521,15,0,15
E 156 & Brook Ave,40.819823,-73.912411,7,11,18
Brook Ave & E 157 St,40.820713,-73.911759,16,0,16
Harlem River Dr & W 155 St,40.830476,-73.939929,5,17,22
Willoughby Ave & Tompkins Ave,40.69425403,-73.94626915,14,4,18
Prospect Ave & Longwood Ave,40.81899,-73.90202,2,26,28
Convent Ave & W 151 St,40.82831,-73.942924,11,12,23
Riverside Dr & W 91 St,40.79313480986663,-73.97700369358063,44,14,58
St. Nicholas Ave & W 157 St,40.832314,-73.94102,11,9,20
W 155 St & Frederick Douglass Blvd,40.82923,-73.936996,28,3,31
Westchester Ave & E 156 St,40.817802,-73.905203,11,12,23
Amsterdam Ave & W 162 St,40.83618,-73.939789,17,9,26
W 160 St & St. Nicholas Ave,40.834468,-73.939865,5,20,25
W 163 St & Riverside Dr,40.839278,-73.945446,4,14,18
E 160 St & Tinton Ave,40.820302,-73.903944,6,15,21
W 165 St & Fort Washington Ave,40.84004,-73.942939,7,17,24
Broadway & W 165 St,40.839137,-73.941409,15,9,24
Fort Washington Ave & W 173 St,40.84522,-73.940493,8,16,24
Amsterdam Ave & W 172 St,40.842173,-73.935111,16,7,23
Frederick Douglass Blvd & Harlem River Dr,40.830702,-73.936371,17,1,18
Broadway & W 160 St,40.835775,-73.9434,7,15,22
Central Park West & W 85 St,40.78476,-73.969862,24,9,33
Amsterdam Ave & W 156 St,40.832081,-73.942386,9,15,24
Adam Clayton Powell Blvd & W 141 St,40.819241,-73.941057,21,1,22
Amsterdam Ave & W 167 St,40.839443,-73.937044,12,10,22
Amsterdam Ave & W 175 St,40.844044,-73.933651,2,21,23
Wadsworth Ave & W 175 St,40.846052,-73.937648,15,9,24
Cabrini Blvd & W 177 St,40.848282,-73.941343,12,11,23
Amsterdam Ave & W 180 St,40.847396,-73.931205,2,20,22
Audobon Ave & W 179 St,40.847305,-73.933291,1,22,23
Wadsworth Ave & W 179 St,40.848467,-73.936064,5,30,35
Old Broadway & W 133 St,40.818212,-73.955277,18,1,19
St. Nicholas Ave & W 155 St,40.830663,-73.941323,10,12,22
Clermont Ave & Park Ave,40.69573398,-73.97129668,11,6,17
Central Park W & W 91 St,40.788664991278836,-73.96680057048798,27,20,47
Amsterdam Ave & W 183 St,40.84925,-73.93022,2,18,20
Gerard Ave & McClellan St,40.833909,-73.92112,19,9,28
Gerard Ave & E 165 St,40.83173,-73.922394,5,16,21
Grand Concourse & E 167 St,40.834263,-73.917641,18,11,29
Gerard Ave & E 164 St,40.830262,-73.923391,3,15,18
Ogden Ave & W 165 St,40.834457,-73.928381,12,6,18
Shakespeare Ave & W 169 St,40.839312,-73.922423,4,14,18
Avenue D & E 10 St,40.72506551015475,-73.97515833377838,22,8,30
E 169 St & Webster Ave,40.834015,-73.908863,19,2,21
Grand Concourse & E 171 St,40.839549,-73.913004,13,11,24
Inwood Ave & W 170 St,40.840536,-73.919228,19,1,20
E 158 St & Melrose Ave,40.822215,-73.914688,18,3,21
Prospect Pl & 6 Ave,40.6793307,-73.97519523,14,10,24
Grand Concourse & E 156 St,40.823429,-73.924689,4,14,18
W 87 St & Amsterdam Ave,40.78839,-73.9747,27,13,40
W 87 St & West End Ave,40.789622,-73.97757,40,4,44
Jerome Ave & Anderson Ave,40.830179,-73.928747,10,6,16
Grand Concourse & E 164 St,40.829608,-73.921461,6,14,20
Morris Ave & McClellan St,40.831584,-73.9149,4,16,20
Walton Ave & E 168 St,40.83649,-73.918316,7,13,20
W 159 St & Edgecombe Ave,40.833303,-73.939326,7,12,19
40 Ave & 9 St,40.75742,-73.945133,17,1,18
Park Ave & E 162 St,40.825716,-73.915585,3,14,17
Ogden Ave & Merriam Ave,40.839142,-73.925961,15,4,19
College Ave & E 170 St,40.837576,-73.910489,0,22,22
Clay Ave & E 173 St,40.843264,-73.904867,4,12,16
E 39 St & Lexington Ave,40.749498546025194,-73.97729203113158,38,25,63
28 Ave & 44 St,40.76408932350688,-73.91065120697021,9,7,16
Southern Blvd & Avenue St. John,40.812769,-73.901583,10,7,17
Beck St & Leggett Ave,40.815077,-73.899939,18,0,18
Jerome Ave & Ogden Ave,40.829797,-73.931015,15,4,19
Longwood Ave & Southern Blvd,40.816343,-73.896447,16,4,20
Westchester Ave & Longwood Ave,40.819701,-73.901311,4,16,20
Southern Blvd & Tiffany St,40.818185,-73.894143,17,1,18
Greenwich St & Hubert St,40.721319,-74.010065,0,35,35
E 163 St & Tiffany St,40.821075,-73.895069,11,6,17
River Ave & E 153 St,40.82441,-73.92818,10,16,26
Hicks St & Montague St,40.69512845,-73.99595065,11,7,18
Concourse Village West & E 156 St,40.823162,-73.923267,16,3,19
Intervale Ave & Westchester Ave,40.821967,-73.896752,19,4,23
Faile St & Garrison Ave,40.820578,-73.888271,16,3,19
Grand Concourse & East Mount Eden Ave,40.84301,-73.91172,8,9,17
E 169 St & Fox St,40.827184,-73.893721,8,10,18
Tinton Ave & E 165 St,40.824796,-73.90242,11,7,18
Southern Blvd & E 172 St,40.834124,-73.88955,16,2,18
W 181 St & Riverside Dr,40.85168,-73.94186,12,7,19
Park Ave & St Edwards St,40.69608941,-73.97803415,52,1,53
Anderson Ave & W 164 St,40.832057,-73.927421,2,16,18
Concourse Village East & E 158 St,40.823732,-73.919379,14,16,30
McGuinness Blvd & Eagle St,40.73555,-73.95284,24,16,40
River Ave & McClellan St,40.83406,-73.92243,17,2,19
Fulton Ave & St. Paul's Pl,40.83545,-73.90153,1,18,19
3 Ave & Franklin Ave,40.82696,-73.907451,12,6,18
Hamilton Pl & W 140 St,40.822756,-73.951346,6,15,21
3 Ave & E 170 St,40.834857,-73.903743,21,0,21
W 20 St & 10 Ave,40.745686,-74.005141,29,18,47
Fulton Ave & E 168 St,40.830471,-73.904556,13,8,21
E 157 St & River Ave,40.825737,-73.927311,12,6,18
Wolcott St & Dwight St,40.6753274,-74.0100698,18,3,21
N 12 St & Bedford Ave,40.72079821,-73.95484712,37,8,45
Carroll St & Smith St,40.680611,-73.99475825,31,7,38
Morris Ave & E 171 St,40.83899,-73.9109,14,6,20
Graham Ave & Conselyea St,40.715143,-73.944507,12,16,28
Clay Ave & Claremont Pkwy,40.83999,-73.90549,13,6,19
Grand St & Havemeyer St,40.71286844,-73.95698119,20,9,29
Dawson St & Intervale Ave,40.819999,-73.897263,9,8,17
3 Ave & E 174 St,40.84224,-73.8985,15,20,35
3 Ave & E 172 St,40.839586,-73.900277,4,14,18
Intervale Ave & Kelly St,40.827301,-73.896372,18,1,19
12 St & 4 Ave,40.668603,-73.9904394,16,8,24
Berkeley Pl & 7 Ave,40.675146838709786,-73.97523209452629,16,12,28
E 167 St & Franklin Ave,40.82895,-73.90521,4,16,20
E 163 St & Union Ave,40.822545,-73.901824,5,19,24
Plaza Dr & W 170 St,40.840484,-73.917946,25,5,30
E 25 St & 2 Ave,40.73912601,-73.97973776,17,55,72
E 171 St & Webster Ave,40.838379,-73.905838,15,5,20
Walton Ave & E 171 St,40.840683,-73.915073,0,18,18
9 St & 44 Rd,40.74966,-73.9521,27,5,32
Sherman Ave & E 166 St,40.83130549267296,-73.91744792461395,2,15,17
Jerome Ave & E 164 St,40.831444,-73.926226,19,0,19
Wards Meadow Comfort Station,40.78294,-73.93077,11,5,16
Icahn Stadium,40.79346,-73.92389,13,4,17
Bronx Shore Comfort Station,40.80046,-73.92404,16,9,25
Sunken Meadow Comfort Station,40.79558,-73.91906,14,10,24
E 153 St & E 157 St,40.826677,-73.929327,7,9,16
Boston Rd & E 167 St,40.828199,-73.903719,15,6,21
E 165 St & Clay Ave,40.82809,-73.91288,18,2,20
Onderdonk Ave & Gates Ave,40.70413,-73.90737,7,10,17
Wilkins Ave & Crotona Park E,40.835302,-73.895133,7,11,18
E 149 St & Park Ave,40.818154,-73.925294,23,1,24
Grand Concourse & E 166 St,40.83196,-73.91956,1,23,24
Prospect Ave & Jennings St,40.831762,-73.896853,18,1,19
Louis Nine Blvd & Intervale Ave,40.831998,-73.892686,15,1,16
E 20 St & 2 Ave,40.73587678,-73.98205027,61,23,84
W 18 St & 6 Ave,40.73971301,-73.99456405,36,33,69
Harman St & Seneca Ave,40.70577,-73.91292,9,7,16
E 161 St & Park Ave,40.824811,-73.916407,3,17,20
University Ave & W 168 St,40.838706,-73.927034,11,7,18
E 170 St & Clay Ave,40.837213,-73.908345,5,20,25
Webster Ave & E 166 St,40.828975,-73.911259,16,2,18
Hunts Point Ave & Bryant Ave,40.813991,-73.8855,10,9,19
Clinton St & Tillary St,40.696232971293156,-73.99142056703568,12,19,31
Franklin Ave & E 169 St,40.83171,-73.90208,9,8,17
Boston Rd & Prospect Ave,40.833246,-73.896599,16,1,17
3 Ave & E 163 St,40.823872,-73.908699,20,5,25
Barry St & Tiffany St,40.816126,-73.891559,17,2,19
Lexington Ave & E 36 St,40.747573958954796,-73.9788007736206,15,5,20
River Ave & E 151 St,40.822217,-73.928939,6,20,26
Washington Ave & E 163 St,40.824,-73.91089,19,1,20
Prospect Ave & E 167 St,40.826303,-73.898751,11,6,17
E 165 St & Fox St,40.82394,-73.894025,8,18,26
Waterloo Pl & Crotona Park East,40.839194,-73.888587,14,1,15
Crotona Park East & E 173 St,40.837037,-73.890413,4,14,18
Boone Ave & E 172 St,40.832649,-73.885272,16,3,19
Grand Army Plaza & Central Park S,40.7643971,-73.97371465,0,0,0
Washington Ave & E 174 St,40.843079,-73.900216,9,10,19
Carroll St & Columbia St,40.6830456,-74.00348559,34,5,39
Bialystoker Pl & Delancey St,40.71622644,-73.98261206,31,1,32
Frederick Douglass Blvd & W 145 St,40.823061,-73.941928,20,6,26
Charlotte St & Boston Rd,40.8358771,-73.8931428,13,5,18
Southern Blvd & E 175 St,40.839335,-73.886445,6,7,13
Lafayette Ave & Hunts Point Ave,40.816567,-73.888161,13,6,19
W 51 St & 6 Ave,40.7606597,-73.98042047,9,72,81
Sheridan Ave & E 172 St,40.840494,-73.911479,0,22,22
Garrison Ave & Manida St,40.818743,-73.890247,22,7,29
E 11 St & 1 Ave,40.72953837,-73.98426726,49,6,55
E 170 St & Webster Ave,40.83617913677475,-73.90730146322765,21,3,24
E 11 St & Avenue B,40.72746420692392,-73.97950418293476,54,12,66
Riverside Dr & W 153 St,40.832164,-73.949702,13,7,20
E 174 St & Walton Ave,40.844811,-73.912042,14,13,27
Fulton Ave & E 172 St,40.839229,-73.899047,4,15,19
Southern Blvd & E 149 St,40.811892,-73.904192,9,18,27
E 68 St & Madison Ave,40.7691572,-73.96703464,29,26,55
E 68 St & 3 Ave,40.76712840349542,-73.96224617958069,1,35,36
E 63 St & 3 Ave,40.763954,-73.9646,32,22,54
Henry St & Bay St,40.6725058,-74.00494695,16,0,16
E 84 St & 1 Ave,40.77565541,-73.95068615,16,6,22
24 Ave & 26 St,40.774591,-73.918544,13,6,19
W 54 St & 11 Ave,40.768333,-73.992573,28,0,28
Westchester Ave & Southern Blvd,40.824956,-73.891677,12,6,18
Seneca Ave & Irvine St,40.81872569990116,-73.88862490653992,7,12,19
E 9 St & Avenue C,40.72521311,-73.97768752,28,18,46
Old Slip & South St,40.70336686695866,-74.007867872715,42,42,84
Lexington Ave & E 24 St,40.74025878,-73.98409214,9,67,76
Hudson St & W 13 St,40.74005708567285,-74.0052741765976,36,6,42
West Thames St,40.70834698,-74.01713445,38,30,68
E 6 St & Avenue B,40.72453734,-73.98185424,47,47,94
Cadman Plaza E & Tillary St,40.69597683,-73.99014892,17,34,51
Spring St & Hudson St,40.72583996792375,-74.0076532959938,39,3,42
Thompson St & Bleecker St,40.72840059450829,-73.99968780577183,29,27,56
34th Ave & Vernon Blvd,40.76535380385866,-73.93986314535141,30,0,30
W 10 St & Washington St,40.73342399437081,-74.00851495563984,49,16,65
34 Ave & 31 St,40.759604471387945,-73.92714411020279,8,10,18
18 St & 27 Ave,40.772768286288304,-73.92743647098541,13,9,22
Washington St & Barrow St,40.73191132323174,-74.008769094944,20,30,50
8 St & Astoria Blvd,40.7725996921817,-73.93266275525093,6,12,18
E 54 St & 1 Ave,40.756265,-73.964179,20,14,34
Southern Blvd & E 174 St,40.836733,-73.887931,13,14,27
24 St & 38 Ave,40.756351,-73.936515,5,12,17
Home St & Westchester Ave,40.827629,-73.886659,7,14,21
Morris Ave & E 163 St,40.827230499624726,-73.91765579597632,15,5,20
35 St & 30 Ave,40.76547569244953,-73.91811579465866,9,20,29
Steinway St & Broadway,40.75905795418586,-73.91897544264793,6,20,26
Nelson Ave & 167 St,40.83670566862804,-73.92608866095543,4,17,21
Shore Blvd & Astoria Park,40.77977,-73.923162,13,20,33
E 44 St & Lexington Ave,40.752643,-73.974996,14,35,49
E 27 St & Park Ave S,40.74275179648995,-73.9847157150507,7,62,69
W 29 St & 9 Ave,40.7500727,-73.99839279,16,11,27
3 Ave & E 169 St,40.832678,-73.905158,10,10,20
34 St & 38 Ave,40.752443,-73.929737,14,0,14
43 St & 35 Ave,40.754139,-73.919543,5,20,25
38 St & Northern Blvd,40.752372,-73.925384,5,18,23
30 Ave & 41 St,40.763422,-73.914142,8,12,20
34 Ave & 45 St,40.754795,-73.917014,2,20,22
30 Ave & 47 St,40.761294,-73.909562,7,13,20
43 St & 37 Ave,40.750181,-73.919998,15,5,20
46 St & 25 Ave,40.765753,-73.90676,8,16,24
50 St & 30 Ave,40.760083,-73.907107,14,9,23
34 Ave & 48 St,40.75388,-73.914952,7,16,23
25 Ave & 41 St,40.767666,-73.910963,7,16,23
48 St & Broadway,40.755763,-73.912715,8,22,30
Bulova Ave & Brooklyn Queens Expressway W,40.762507,-73.902534,3,14,17
Broadway & 49 St,40.755389,-73.911517,7,17,24
50 St & Northern Blvd,40.753441,-73.912402,11,11,22
31 Ave & 57 St,40.757357,-73.904726,16,7,23
Broadway & 51 St,40.754164,-73.908906,13,14,27
43 St & 23 Ave,40.769673,-73.906018,4,15,19
W 95 St & Broadway,40.7937704,-73.971888,7,23,30
62 St & Northern Blvd,40.754176,-73.900318,24,1,25
E 12 St & Ave C,40.727243,-73.976831,26,15,41
57 St & 1 Ave,40.646377,-74.023087,27,0,27
Steinway St & Ditmars Blvd,40.772717,-73.906127,5,16,21
58 St & 2 Ave,40.644512,-74.021506,34,0,34
36 St & Ditmars Blvd,40.774306,-73.908335,8,16,24
Ditmars Blvd & 43 St,40.771203,-73.903865,12,14,26
Steinway St & 21 Ave,40.774798,-73.903787,15,5,20
31 St & 21 Ave,40.77813,-73.90842,5,21,26
21 Ave & Shore Blvd,40.783956,-73.916894,13,6,19
21 Ave & Crescent St,40.780478,-73.912212,18,6,24
Hazen St & 20 Ave,40.772092,-73.895166,20,3,23
Steinway St & 19 Ave,40.778089,-73.899558,17,4,21
Ditmars Blvd & 79 St,40.768728,-73.890745,18,7,25
76 St & 21 Ave,40.77028,-73.893675,18,2,20
8 Ave & W 27 St,40.747968,-73.996637,12,16,28
E 14 St & Avenue B,40.72938685,-73.97772429,19,22,41
E 13 St & 2 Ave,40.73153937464073,-73.9853024482727,31,21,52
20 Ave & 38 St,40.777112,-73.902382,21,6,27
20 Ave & 48 St,40.772899,-73.896849,23,0,23
Windsor Pl & 8 Ave,40.660906,-73.983074,12,7,19
38 St & 30 Ave,40.764174520197685,-73.91583994030952,8,17,25
16th St & 4th Ave,40.666197,-73.992466,29,0,29
17 St & 5 Ave,40.663493,-73.991007,13,12,25
6 Ave & 21 St,40.66016,-73.990974,7,19,26
21 St & 4 Ave,40.662584,-73.995554,20,0,20
Prospect Park W & 20 St,40.656633,-73.983864,14,11,25
23 St & 3 Ave,40.662611,-73.998623,22,1,23
30 St & 4 Ave,40.657743,-74.001141,18,1,19
11 Ave & Prospect Ave,40.65629,-73.977335,10,9,19
34 St & 4 Ave,40.655278,-74.003101,16,7,23
2 Av & 37 St,40.656326,-74.009627,29,0,29
3 Ave & 17 St,40.666168,-73.995549,17,3,20
29 St & 5 Ave,40.656986,-73.998194,18,1,19
34 St & 5 Ave,40.654098,-74.001131,11,3,14
5 Ave & 37 St,40.652657,-74.002356,8,21,29
2 Ave & E 29 St,40.741723510974715,-73.97809267044067,26,29,55
2 Ave & 32 St,40.659176,-74.006584,26,1,27
Albany St & Greenwich St,40.709267,-74.013247,24,15,39
41 St & 3 Ave,40.652512,-74.008906,17,2,19
41 St & 4 Ave,40.651354,-74.007168,18,4,22
5 Ave & 41 St,40.649983,-74.005144,20,7,27
7 Ave & 20 St,40.659053,-73.98854,18,2,20
Forsyth St & Grand St,40.71779817737835,-73.99316132068634,36,22,58
24 St & 5 Ave,40.659555,-73.995068,14,4,18
7 Ave & 22 St,40.658029,-73.989605,8,17,25
W 31 St & 7 Ave,40.749156,-73.9916,52,12,64
48 St & 2 Ave,40.650176,-74.015606,7,12,19
46 St & 6 Ave,40.645921,-74.005708,14,7,21
44 St & 6 Ave,40.647105,-74.004483,12,9,21
Ft. Hamilton Pkwy & E 5 St,40.649037,-73.97673,13,8,21
Greenwood Ave & E 4 St,40.650739,-73.977739,6,14,20
Clinton St & Cherry St,40.711471394469264,-73.98672603070736,29,3,32
46 St & 7 Ave,40.644743,-74.003754,11,10,21
55 St & 5 Ave,40.642408,-74.013318,3,24,27
52 St & 1 Ave,40.649292,-74.020105,20,0,20
53 St & 5 Ave,40.643371,-74.011884,11,18,29
52 St & 6 Ave,40.642703,-74.009441,7,12,19
53 St & 4 Ave,40.644862,-74.014531,22,2,24
59 St & 4 Ave,40.641269,-74.017651,1,31,32
Ft. Hamilton Pkwy & E 2 St,40.648005,-73.979342,17,1,18
64 St & 3 Ave,40.639978,-74.02324,31,3,34
6 Ave & 60 St,40.638196,-74.013821,6,16,22
36 St & 4 Ave,40.654144,-74.00422,23,3,26
7 Ave & 40 St,40.648169,-74.000057,8,14,22
44 St & 3 Ave,40.651173,-74.011405,22,0,22
Prospect Park SW & 10 Ave,40.659945,-73.977504,22,4,26
Windsor Pl & Howard Pl,40.659490558938955,-73.98013919591904,3,19,22
36 St & 3 Ave,40.655716,-74.006664,23,3,26
57 St & 4 Ave,40.642622,-74.016866,3,19,22
55 St & 7 Ave,40.639673,-74.008957,4,20,24
Dahill Rd & 12 Ave,40.646037,-73.980963,14,8,22
Prospect Park SW & Greenwood Ave,40.652563,-73.972573,25,1,26
E 8 St & Caton Ave,40.648055,-73.972432,18,12,30
Caton Ave & E 10 St,40.648481,-73.97058,27,0,27
Albemarle Rd & McDonald Ave,40.645074,-73.979681,13,6,19
E 3 St & Church Ave,40.643817,-73.977433,12,9,21
Caton Ave & E 7 St,40.647718,-73.973663,18,2,20
Lenox Ave & W 140 St,40.817245,-73.938787,19,1,20
4 Ave & Shore Road Dr,40.637033,-74.022141,15,0,15
Greenwich St & Perry St,40.73498,-74.00697,39,6,45
Parade Pl & Crooke Ave,40.651847,-73.965248,27,1,28
6 Ave & 55 St,40.640831,-74.010996,13,6,19
7 Ave & 41 St,40.647379,-74.000911,18,6,24
65 St & 2 Ave,40.640493,-74.02564,9,12,21
Church Ave & Story St,40.642031,-73.981073,16,6,22
12 Ave & 36 St,40.643546,-73.986418,14,5,19
Chester Ave & 12 Ave,40.644367,-73.984276,19,1,20
5 Ave & 66 St,40.635679,-74.020005,7,13,20
3 Ave & Wakeman Pl,40.638246,-74.024714,24,2,26
47 St & 3 Ave,40.649143,-74.012384,22,1,23
Church Ave & McDonald Ave,40.642809,-73.979239,12,17,29
67 St & Erik Pl,40.633385,-74.016562,10,10,20
48 St & 5 Ave,40.646351,-74.009271,22,5,27
63 St & 5 Ave,40.63766,-74.01782,13,9,22
Wyckoff Ave & Gates Ave,40.699871408829885,-73.91171872615814,1,35,36
Park Cir & East Dr,40.651566,-73.972212,26,3,29
Broadway & W 192 St,40.857994,-73.932173,17,6,23
Nagle Ave & Thayer St,40.861382,-73.925591,30,3,33
Broadway & W 185 St,40.852538,-73.93441,18,1,19
10 Ave & W 14 St,40.741981599940225,-74.00831580162048,42,11,53
Ft. Washington Ave & W 190 St,40.856906,-73.935662,1,17,18
W 190 St & Broadway,40.85648733523576,-73.93296986818314,6,13,19
India St Pier,40.731734785883454,-73.9612390102593,51,2,53
Broadway & Ellwood St,40.862058,-73.929719,19,0,19
Nagle Ave & Ellwood St,40.86012,-73.928489,19,2,21
Grand Army Plaza & Plaza St West,40.6729679,-73.97087984,7,31,38
Seaman Ave & Beak St,40.867505,-73.926363,21,0,21
Dyckman St & Staff St,40.868846,-73.931537,14,4,18
W 204 St & Nagle Ave,40.863211,-73.920827,8,11,19
10 Ave & W 204 St,40.862638,-73.92006,7,12,19
Dyckman St & Henshaw St,40.867357,-73.92936,11,8,19
Warren St & W Broadway,40.71473993,-74.00910627,4,67,71
Isham St & Broadway,40.86788,-73.919685,25,4,29
10 Ave & W 207 St,40.864632,-73.918598,35,2,37
1 Ave & E 6 St,40.72633085971696,-73.98616880178452,71,19,90
W 204 St & Vermilyea Ave,40.866141,-73.922648,19,2,21
Bergen St & 4 Ave,40.68256425759694,-73.9798977971077,23,10,33
10 Ave & W 202 St,40.861281970750994,-73.921417593956,18,4,22
Leonard St & Church St,40.717571,-74.005549,11,43,54
E 9 St & 5 Ave,40.73275887045087,-73.99581670761108,37,22,59
Margaret Corbin Plz & Ft Washington Ave,40.859166,-73.933872,8,15,23
Grand St & Samuel Dickstein Plaza,40.715118719964956,-73.98417055606842,56,18,74
10 Ave & W 215 St,40.86932465640094,-73.91519755125046,21,0,21
W 218 St & Indian Rd,40.873054589370895,-73.91837194561958,18,3,21
1 St & 6 Ave,40.672784,-73.979826,24,9,33
E 171 St & 3 Ave,40.837119,-73.902185,18,4,22
Bay St & Court St,40.671409,-74.001328,24,2,26
Prospect Park SW & 16 St,40.657265,-73.974165,28,4,32
Congress St & Hicks St,40.6893952,-73.9995126,29,5,34
Warren St & Smith St,40.685424009970184,-73.99127773940563,17,14,31
59 St & 5 Ave,40.640125,-74.015726,15,15,30
Prospect Park SW & Vanderbilt St,40.65482,-73.973217,31,5,36
Broadway & W 168 St,40.84089603193041,-73.93972098827362,10,20,30
Sherman Ave & Thayer St,40.863124,-73.926994,11,10,21
Van Brunt St & Van Dyke St,40.6758329439129,-74.01472628116608,20,2,22
Hart St & Wyckoff Ave,40.704876,-73.919911,21,3,24
9 Ave & W 219 St,40.871094,-73.911503,17,2,19
Broadway & W 220 St,40.872412,-73.912807,17,1,18
W 218 St & Broadway,40.87139,-73.914318,12,14,26
4 Ave & 3 St,40.673746,-73.985649,34,3,37
Dyckman St & 10 Ave,40.85890447538412,-73.9230939745903,17,0,17
St Marks Pl & 4 Ave,40.68177810928762,-73.97988975048065,24,2,26
Featherbed Ln & Nelson Ave,40.846011,-73.919637,7,15,22
45 St & 4 Ave,40.649145,-74.009486,18,5,23
Anthony Ave & E 175 St,40.846465,-73.903869,9,10,19
4 Ave & 26 St,40.660079,-73.998633,10,14,24
Jerome Ave & W 177 St,40.850121,-73.910765,27,0,27
Soissons Landing,40.69231660719192,-74.01486575603485,15,12,27
Yankee Ferry Terminal,40.68706579875912,-74.01675585121666,20,18,38
Picnic Point,40.68512559515415,-74.02535319328308,23,20,43
Amsterdam Ave & W 79 St,40.7829391,-73.9786517,35,10,45
Anthony Ave & E Tremont Ave,40.848793,-73.903178,5,8,13
E Tremont Ave & Jerome Ave,40.851747,-73.908964,9,9,18
South Waterfront Walkway - Sinatra Dr & 1 St,40.73698221818716,-74.02778059244156,7,23,30
11 St & Washington St,40.74998490907138,-74.02715027332306,11,9,20
President St & 4 Ave,40.676757,-73.983262,7,24,31
Mama Johnson Field - 4 St & Jackson St,40.74313993965626,-74.04004096984863,13,6,19
Ave D & E 8 St,40.72368361,-73.97574813,21,9,30
W Burnside Ave & University Ave,40.853686,-73.912498,13,10,23
W Tremont Ave & Montgomery Ave,40.851788,-73.916418,2,18,20
Davidson Ave & W Burnside Ave,40.853646,-73.908731,27,2,29
E Tremont Ave & E 176 St,40.847798,-73.901883,18,3,21
Madison St & 1 St,40.73879,-74.0393,21,0,21
Church Sq Park - 5 St & Park Ave,40.74265933273143,-74.03223305940628,3,17,20
Bloomfield St & 15 St,40.75453,-74.02658,3,9,12
19 St & 8 Ave,40.658489,-73.985543,16,6,22
Sedgwick Ave & W Burnside Ave,40.854947,-73.916661,8,7,15
E 20 St & Park Ave,40.73827428,-73.98751968,10,30,40
Lexington Ave & Classon Ave,40.68676793,-73.95928168,7,9,16
Walton Ave & E 183 St,40.858472,-73.90266,17,11,28
Academy St & Nagle Ave,40.862562,-73.922661,19,1,20
Southwest Park - Jackson St & Observer Hwy,40.73755127245804,-74.04166370630264,15,3,18
Cedar Ave & W Fordham Rd,40.86156,-73.91219,4,20,24
Jerome Ave & E 181 St,40.855653,-73.905528,15,4,19
E 33 St & 1 Ave,40.74322681432173,-73.97449783980846,30,49,79
6 St & Grand St,40.744397833095604,-74.03450086712837,14,3,17
Madison St & 10 St,40.74994325412246,-74.03586477041245,16,4,20
Grand St & 14 St,40.75409,-74.0316,13,5,18
W Tremont Ave & Grand Ave,40.850036,-73.912785,7,13,20
University Ave & Brandt Pl,40.848354,-73.918389,5,16,21
Andrews Ave S & W 179 St,40.855156,-73.91278,6,12,18
Webster Ave & Ford St,40.85556,-73.89615,17,0,17
E 188 St & Creston Ave,40.861669,-73.898589,7,24,31
Henry St & Remsen St,40.69400964865994,-73.99465128779411,18,5,23
Bridge St & Water St,40.702969341552716,-73.98469090461731,31,14,45
Jerome Ave & W 193 St,40.86659,-73.89794,5,9,14
Grand Ave & W Fordham Rd,40.86288,-73.90316,5,16,21
E 11 St & 3 Ave,40.73127,-73.98849,29,47,76
Clinton St & 7 St,40.74542,-74.03332,5,11,16
4 St & Grand St,40.7422579775645,-74.03511106967926,7,11,18
9 St HBLR - Jackson St & 8 St,40.74790720968899,-74.03841152787209,2,13,15
7 St & Monroe St,40.74641264837719,-74.03797701001167,9,13,22
Morris Ave & E 184 St,40.86008,-73.90079,4,17,21
Andrew Ave N & Hall of Fame Tce,40.85834,-73.91008,3,15,18
E Burnside Ave & Ryer Ave,40.850535,-73.901318,19,0,19
Valentine Ave & E 183 St,40.856987,-73.898237,1,20,21
Bainbridge Ave & E 193 St,40.86389,-73.89246,19,8,27
Grand Concourse & E 197 St,40.86945,-73.89148,4,17,21
Goulden Ave & Bedford Park Blvd W,40.87387,-73.89533,5,13,18
Grand Concourse & E 199 St,40.87142,-73.88839,5,14,19
Bedford Park Blvd & Paul Ave,40.87444,-73.89186,5,15,20
Goulden Ave & W 197 St,40.87156,-73.89714,15,0,15
Ocean Pkwy & Church Ave,40.644718957635746,-73.97451460361481,16,9,25
Lewis Ave & Madison St,40.686312,-73.935775,13,7,20
Grand Concourse & E 203 St,40.87382,-73.88661,7,18,25
Grand Concourse & E 192 St,40.86448,-73.89522,2,16,18
Marion Ave & Mosholu Pkwy,40.8704956,-73.8818756582,10,10,20
Dock St & Front St,40.702709,-73.99253,5,21,26
Nassau St & Duffield St,40.698477,-73.98384,53,0,53
Myrtle Ave & Fleet Pl,40.693534,-73.981909,36,9,45
University Ave & W Burnside Ave,40.85501,-73.910751,4,20,24
Morris Ave & E Burnside Ave,40.85322,-73.90546,10,10,20
Hoboken Terminal - Hudson St & Hudson Pl,40.73593758446329,-74.03030455112457,8,15,23
Amsterdam Ave & W 186 St,40.851113,-73.928808,15,6,21
E Fordham Rd & Webster Ave,40.861748,-73.89105,25,6,31
Decatur Ave & E 197 St,40.86557,-73.88807,15,4,19
W Fordham Rd & Loring Pl N,40.86295,-73.90741,8,17,25
Jerome Ave & W 184 St,40.860814,-73.902541,4,16,20
Bailey Ave & Sedgwick Ave,40.86571,-73.90857,8,9,17
Bainbridge Ave & E 196 St,40.86648,-73.89042,4,15,19
Grand Concourse & E 196 St,40.86767,-73.89286,5,20,25
Creston Ave & E 181 St,40.8549,-73.90281,5,18,23
Botanical Sq & Webster Ave,40.86814,-73.88145,26,3,29
Decatur Ave & Bedford Park Blvd,40.86813,-73.88412,14,1,15
Goulden Ave & W 205 St,40.87812,-73.89192,16,3,19
Bainbridge Ave & Bedford Park Blvd,40.87002,-73.88565,17,2,19
E Mosholu Pkwy & Van Cortlandt Ave E,40.87656,-73.88366,1,19,20
Jerome Ave & E Mosholu Parkway S,40.87935,-73.88534,10,12,22
Paul Ave & W 205 St,40.87704,-73.88943,2,14,16
Grand Concourse & E Mosholu Pkwy S,40.877964,-73.8847550291,3,17,20
McDonald Ave & Vanderbilt St,40.651654,-73.981231,18,1,19
W Mosholu Pkwy S & Sedgwick Ave,40.88226,-73.88702,17,16,33
Spruce St & Gold St,40.7103231,-74.0043228,35,20,55
Jerome Ave & W 195 St,40.86874,-73.89657,8,23,31
Tiebout Ave & E 184 St,40.858498,-73.89637,7,10,17
Adams St & Prospect St,40.700763083261506,-73.98869812488556,12,45,57
Bailey Ave & W 193 St,40.87069,-73.90678,20,3,23
Sands St & Jay St,40.700119,-73.9862,13,33,46
Paul Ave & Mosholu Pkwy,40.8802945,-73.8860653648,7,11,18
Grand Concourse & E 205 St,40.875531,-73.8863864831,3,13,16
Jerome Ave & Bedford Park Blvd E,40.87307,-73.88971,19,3,22
Frederick Douglass Blvd & W 139 St,40.81900581806558,-73.94476890563965,22,0,22
Broadway & W 142 St,40.824686,-73.951947,12,11,23
Bergen Ave & Stegman St,40.70657545063453,-74.0867006778717,13,6,19
5 Ave & W 126 St,40.80722,-73.9418,17,8,25
Bridge St & York St,40.70133448066992,-73.98471236228943,28,24,52
Webb Ave & W 190 St,40.8660052,-73.904254892,3,17,20
Aqueduct Ave & North St,40.8604787,-73.9057169936,10,6,16
6 Ave & Broome St,40.72431,-74.00473,19,43,62
E Mosholu Pkwy & E 204 St,40.8740704,-73.8833650931,18,0,18
E 91 St & 2 Ave,40.781152764279156,-73.94963040947914,60,13,73
Central Park W & W 103 St,40.79558954105342,-73.96188408136368,15,25,40
Fulton St & William St,40.70960089363537,-74.00655090808868,11,29,40
Montague St & Clinton St,40.6942715,-73.9923272,9,19,28
E 88 St & 1 Ave,40.778301,-73.9488134,31,3,34
Congress St & Clinton St,40.68825516598005,-73.99545192718506,31,12,43
Bushwick Ave & Powers St,40.71247661,-73.94100005,23,8,31
Grand Concourse & E 161 St,40.82713380423556,-73.9227358996868,25,0,25
E 59 St & Madison Ave,40.76350532,-73.97109243,18,31,49
Sterling St & Bedford Ave,40.6627059,-73.9569115,16,3,19
Willow Ave & 12 St,40.7518674823282,-74.03037697076797,11,2,13
Sedgwick Ave & Hall of Fame Tce,40.859532,-73.913303,3,16,19
Macombs Rd & Featherbed Ln,40.84552,-73.91722,14,1,15
62 St & 4 Ave,40.639859,-74.019776,15,2,17
Jerome Ave & E 198 St,40.87144520687118,-73.89289632439613,12,7,19
Grant Ave & MLK Dr,40.70919832245443,-74.08084273338318,12,3,15
Creston Ave & E 178 St,40.850885,-73.906469,9,18,27
Loring Pl North & W 183 St,40.8604244,-73.9093359997,5,13,18
Green St & McGuinness Blvd,40.73396,-73.95204,17,2,19
W 192 St & University Ave,40.866899,-73.901942,6,12,18
Decatur Ave & Oliver Pl,40.867,-73.8857764,18,2,20
Bainbridge Ave & E 198 St,40.8684871,-73.8884559781,15,8,23
Broadway & W 56 St,40.7652654,-73.98192338,47,64,111
E 201 St & Briggs Ave,40.87207,-73.88459,18,1,19
Rogers Ave & Sterling St,40.6630619,-73.9538746,17,0,17
Broadway & W 38 St,40.7529728216068,-73.98734897375107,6,58,64
Broadway & E 21 St,40.739888408589955,-73.98958593606949,5,46,51
E 5 St & Avenue C,40.72299208,-73.97995466,37,18,55
E 1 St & 1 Ave,40.72335597960796,-73.98864984512329,4,66,70
Longfellow Ave & E 165 St,40.825322,-73.887729,0,20,20
20 Ave & 21 St,40.784003,-73.912297,9,10,19
20 Ave & Shore Blvd,40.785994,-73.915098,15,3,18
Richardson St & N Henry St,40.71907891179564,-73.94223690032959,18,7,25
12 St & Sinatra Dr N,40.750604142368964,-74.02402013540268,24,3,27
W 168th S & Fort Washington Ave,40.84210236102173,-73.9422395825386,32,15,47
Mt Morris Park W & W 120 St,40.804038,-73.945925,17,10,27
W 144 St & Adam Clayton Powell Blvd,40.820877,-73.939249,19,2,21
E 103 St & Lexington Ave,40.7903051,-73.94755757,27,6,33
Division Ave & Hooper St,40.70684203101325,-73.9544353965357,26,33,59
Sullivan St & Washington Sq,40.73047747,-73.99906065,26,13,39
Vesey St & Church St,40.71221958009051,-74.01047229766846,15,27,42
W 225 St & Exterior St,40.873265,-73.906646,7,12,19
Broadway & W 53 St,40.76344058,-73.98268129,23,60,83
Fulton St & Clermont Ave,40.68415748,-73.96922273,24,48,72
5 Ave & E 87 St,40.78232260730881,-73.95987510681152,17,21,38
49 St & 31 Ave,40.758057,-73.909831,4,14,18
49 St & 25 Ave,40.764496,-73.904632,17,8,25
31 Ave & 61 St,40.757525,-73.901614,19,1,20
Courtlandt Ave & E 149 St,40.816402,-73.919549,5,16,21
Macombs Rd & W 175 St,40.848177,-73.916082,9,10,19
20 Ave & 42 St,40.775415,-73.900063,19,0,19
Flatbush Ave & Ocean Ave,40.663657,-73.963014,20,18,38
Water St & Gouverneur Ln,40.70469667894968,-74.00803416967392,21,15,36
53 St & 2 Ave,40.64744,-74.018846,27,3,30
Nelson Ave & W 172 St,40.843965,-73.920999,5,11,16
W 22 St & 10 Ave,40.74691959,-74.00451887,42,25,67
W 37 St & 5 Ave,40.75038009,-73.98338988,8,52,60
E 48 St & 5 Ave,40.75724567911726,-73.97805914282799,15,31,46
W 44 St & 5 Ave,40.75500254,-73.98014437,22,45,67
Ryer Ave & E 182 St,40.8558,-73.89956,2,22,24
Plaza St West & Flatbush Ave,40.6750207,-73.97111473,9,22,31
Bergen St & Flatbush Ave,40.680944723477296,-73.97567331790923,11,12,23
City Hall - Washington St & 1 St,40.73736,-74.03097,12,8,20
Clinton St & Newark St,40.73743,-74.03571,5,8,13
W 176 St & Montgomery Ave,40.849629,-73.919205,2,11,13
Popham Ave & W 174 St,40.847746,-73.922079,6,11,17
Coffey St & Ferris St,40.67818387977647,-74.0170168876648,20,2,22
Prospect Ave & Greenwood Ave,40.651745,-73.975988,13,10,23
1 Pl & Clinton St,40.6809591,-73.99905709,25,9,34
E 41 St & Madison Ave (SE corner),40.752049,-73.979635,28,54,82
Broadway & W 58 St,40.76695317,-73.98169333,55,13,68
W 37 St & 10 Ave,40.75660359,-73.9979009,16,20,36
W 36 St & 9 Ave,40.75462324029105,-73.99516761302948,7,31,38
Washington St & Gansevoort St,40.739323,-74.008119,41,5,46
58 St & Pier 4,40.646475,-74.026081,15,15,30
Adams St & 2 St,40.73981372311843,-74.03690412640572,9,5,14
45 Ave & 21 St,40.74737075646803,-73.94777297973631,6,14,20
51 St & Hobart St,40.75767234025041,-73.90769943594933,7,16,23
Grand Ave & W 181 St,40.856302,-73.907302,8,9,17
Marshall St & 2 St,40.740802,-74.042521,3,14,17
Broadway & W 61 St,40.77003010255044,-73.9819684624672,13,37,50
E 55 St & 2 Ave,40.75797322,-73.96603308,9,19,28
14 St & 7 Ave,40.663779,-73.98396846,7,16,23
Railroad Ave & Kay Ave,40.70514807698391,-73.97078096866608,25,5,30
5 St & Market St,40.699997484388504,-73.97440128028393,15,23,38
University Pl & E 8 St,40.73143724085228,-73.99490341544151,50,24,74
Suffolk St & Stanton St,40.72066442,-73.98517977,14,58,72
King St & Varick St,40.72789701409023,-74.00536268949507,25,10,35
9 Ave & W 45 St,40.76019252,-73.9912551,16,14,30
9 Ave & W 18 St,40.74317449,-74.00366443,44,39,83
MacDougal St & Prince St,40.72710258,-74.00297088,47,3,50
E 133 St & Cypress Pl,40.80262,-73.9174,14,2,16
Van Buren St & Broadway,40.692,-73.92617,8,13,21
23 Rd & 31 St,40.77336750284339,-73.91382560133934,5,16,21
Avenue D & E 12 St,40.72580614,-73.97422494,28,11,39
Mercer St & Bleecker St,40.72706363348306,-73.99662137031554,53,13,66
Great Jones St,40.72743423,-73.99379025,4,9,13
E 170 St & Sheridan Ave,40.838315,-73.912604,3,26,29
1 Ave & E 39 St,40.74714,-73.97113,26,22,48
Maiden Ln & Pearl St,40.70706456,-74.00731853,28,0,28
8 Ave & W 52 St,40.76370739,-73.9851615,17,13,30
Duane St & Hudson St,40.71703,-74.00925,12,30,42
W 48 St &  Rockefeller Plaza,40.75776935448309,-73.97929430007935,6,13,19
Washington Square E,40.73049393,-73.9957214,3,61,64
Sterling Pl & 5 Ave,40.678970070475735,-73.97855266928671,26,1,27
W 42 St & 8 Ave,40.7575699,-73.99098507,36,2,38
W 47 St & 6 Ave,40.758397,-73.98255,3,59,62
Broadway & W 41 St,40.75513557,-73.98658032,1,53,54
E 5 St & Ave A,40.72479007746337,-73.98430064320564,30,18,48
E 167 St & Clay Ave,40.83094,-73.91125,26,4,30
W 12 St & Hudson St,40.73752993301071,-74.00558933615685,31,11,42
Ogden Ave & W 164 St,40.832812,-73.929372,2,17,19
Broadway & Morris St,40.705945132708806,-74.01321887969969,18,46,64
W 34 St & Hudson Blvd E,40.75516719072139,-74.00059908628464,8,43,51
West Broadway & Watts St,40.72323,-74.00314,21,14,35
Greene St & Prince St,40.72511734422387,-73.99930492043495,31,7,38
Washington St & Laight St,40.72231,-74.0106,29,14,43
Fairmount Ave,40.72572613742557,-74.07195925712585,12,4,16
Stevens - River Ter & 6 St,40.74313282710551,-74.02698867022991,10,5,15
South St & Pike St,40.70991806921533,-73.99161100387573,31,2,33
E 10 St & 2 Ave,40.72970805644994,-73.9865979552269,31,5,36
7 Ave S & Bleecker St,40.73213896287381,-74.00363802909851,70,11,81
6 Ave & Walker St,40.7197920901383,-74.0052238852195,3,36,39
W 56 St & 6 Ave,40.76340613,-73.97722479,9,44,53
Rutgers St & Henry St,40.71332151208186,-73.99009689688683,36,4,40
Water St &  Fletcher St,40.706410755236135,-74.00559738278389,78,0,78
Hoe Ave & Jennings St,40.832171,-73.889686,6,13,19
Grand Concourse & E 144 St,40.816576,-73.927987,17,6,23
E 26 St & 3 Ave,40.74069317733043,-73.98160636425018,11,22,33
E 22 St & 2 Ave,40.73716919369882,-73.98122549057007,7,24,31
31 St & Ditmars Blvd,40.776168,-73.910485,2,22,24
W Tremont Ave & Matthewson Rd,40.853827,-73.920765,19,0,19
E 20 St & FDR Dr,40.733208626522426,-73.9756813647,69,3,72
W 30 St & 8 Ave,40.74965268472847,-73.9952078461647,33,27,60
Ave A & E 14 St,40.73031071000895,-73.98047178983688,0,29,29
Ave A & E 11 St,40.72854745023944,-73.98175925016403,56,8,64
Central Ave & Weirfield St,40.69055,-73.91181,9,10,19
Perry St & Greenwich Ave,40.735918,-74.000939,39,13,52
Kenmare St & Elizabeth St,40.72054,-73.9949,9,27,36
Orchard St & Grand St,40.717318403855785,-73.99067759513855,22,9,31
Tiebout Ave & E Fordham Road,40.861915,-73.894831,22,6,28
Valentine Ave & E 181 St,40.854123869116,-73.89932222664356,5,16,21
Madison St & Montgomery St,40.713126,-73.984844,16,3,19
Audubon Ave & W 192 St,40.85589030603889,-73.92708241939545,10,9,19
Grand Concourse & E 175 St,40.84627592921954,-73.90931278467178,4,17,21
Calyer St & Guernsey St,40.72755807335852,-73.95505852997303,20,0,20
E 156 St & Courtlandt Ave,40.82123860172,-73.9173299074173,13,8,21
W 56 St & 8 Ave,40.765959181657976,-73.98313522338867,38,8,46
Walker St & Baxter St,40.717411,-73.999573,36,8,44
Central Park W & W 97 St,40.79249519495111,-73.96417066463071,29,23,52
W 111 St & 5 Ave,40.797520781247556,-73.9489397406578,18,4,22
Myrtle Ave & Lewis Ave,40.69681963,-73.93756926,2,20,22
W 180 St & Ft Washington Ave,40.849972,-73.938423,10,13,23
W 35 St & 8 Ave,40.752762088742045,-73.99280458705107,40,11,51
Driggs Ave & Lorimer St,40.72179134,-73.9504154,18,7,25
Huron St & Franklin St,40.73266,-73.95826,34,0,34
Broadway & E 19 St,40.73866091428551,-73.98987293243407,9,32,41
Clark St & Henry St,40.69760127,-73.99344559,23,18,41
Allen St & Hester St,40.71605866,-73.99190759,71,44,115
Suydam St & St. Nicholas Ave,40.70636,-73.91945,15,2,17
Murray St & West St,40.71503,-74.01246,9,49,58
Stockholm St & Wilson Ave,40.699304,-73.923044,16,5,21
Jefferson Ave & Evergreen Ave,40.68989,-73.91458,2,14,16
E 182 St & Morris Ave,40.85670801831255,-73.90265285968779,2,17,19
7 Ave & 17 St,40.660937794931684,-73.98680448532104,3,15,18
University Ave & Macombs Rd,40.8496401,-73.9161206,2,20,22
Rogers Pl & E 165 St,40.82388366441761,-73.8974027708582,14,5,19
N Moore St & Hudson St,40.71996118117138,-74.00844320654869,13,50,63
E Houston St & Columbia St,40.71978635452822,-73.97871628403664,48,2,50
E 138 St & Park Ave,40.81263616769319,-73.92924964427948,6,11,17
Prospect Ave & Vanderbilt St,40.653368,-73.976291,11,8,19
Hoboken Terminal - River St & Hudson Pl,40.7360676564825,-74.02912706136703,4,41,45
Wakeman Pl & Ridge Blvd,40.639421,-74.026823,13,4,17
W 211 St & 10 Ave,40.86709406268147,-73.9172950387001,15,2,17
Madison Ave & E 26 St,40.742684734875695,-73.98671329021454,9,65,74
St Marks Pl & 1 Ave,40.72779126,-73.98564945,68,0,68
Sharon St & Olive St,40.715341620424475,-73.93865078687668,13,10,23
West End Ave & W 94 St,40.7941654,-73.974124,8,19,27
30 Ave & 12 St,40.771717105208275,-73.93159255385399,28,4,32
E 35 St & Madison Ave,40.74848023448579,-73.98255586624146,31,14,45
8 Ave & W 24 St,40.74591072834279,-73.99807110428809,27,10,37
Columbus Ave & W 95 St,40.7919557,-73.968087,34,5,39
E 58 St & Madison Ave,40.76302594280519,-73.97209525108337,24,39,63
8 Ave & W 16 St,40.740983,-74.001702,11,21,32
W 13 St & 7 Ave,40.73781509,-73.99994661,27,0,27
Van Dam St & Greenpoint Ave,40.73443564069459,-73.93790781497955,15,4,19
Bradley Ave & Greenpoint Ave,40.73565914819229,-73.93478840589523,13,7,20
Borden Ave & Review Ave,40.73866345465306,-73.94093804061413,10,9,19
31 Pl & Hunters Point Ave,40.74021356884924,-73.93537044525146,14,5,19
Skillman Ave & 43 Ave,40.74653761978055,-73.93215849995613,13,3,16
33 St & 47 Ave,40.74283,-73.9321,18,6,24
W 37 St & Broadway,40.75227093837409,-73.98770570755005,3,78,81
36 St & Queens Blvd,40.74408,-73.92901,0,20,20
Skillman Ave & Honeywell St,40.747148249032804,-73.92902433872223,8,11,19
36 St & 47 Ave,40.742218349960964,-73.92935156822205,4,14,18
Amsterdam Ave & W 189 St,40.85318758861975,-73.92715752124786,1,16,17
36 St & Hunters Point Ave,40.73781699881193,-73.93024072051048,14,7,21
34 St & 48 Ave,40.740821207823245,-73.93147185444832,12,12,24
39 St & Queens Blvd,40.74431,-73.92601,8,13,21
39 St & 50 Ave,40.73824937345944,-73.92737478017807,12,7,19
43 St & Skillman Ave,40.74692675687384,-73.9208248257637,6,12,18
39 St & 47 Ave,40.74215636827728,-73.92662644386292,5,14,19
48 Ave & 41 St,40.73985995699164,-73.92400324344635,10,9,19
42 Pl & Northern Blvd,40.753091,-73.920603,13,12,25
44 St & 48 Ave,40.73941387498411,-73.92131969332695,18,5,23
43 Ave & 42 St,40.74534682580983,-73.9219419658184,20,4,24
43 St & 50 Ave,40.73787237950538,-73.92264068126678,4,14,18
Kane St & Clinton St,40.6861758,-73.99645295,24,0,24
Bergen Ave & Sip Ave,40.73100888698729,-74.06443700194359,2,27,29
50 St & Barnett Ave,40.750097682094825,-73.91349703073502,20,4,24
48 St & Skillman Ave,40.74622874694195,-73.91616314649582,11,10,21
46 St & Queens Blvd,40.74349759836971,-73.91860529780388,15,17,32
51 St & Queens Blvd,40.7429,-73.91395,12,7,19
48 St & 50 Ave,40.73737,-73.91803,8,13,21
51 St & 43 Ave,40.74451,-73.91412,11,16,27
43 Ave & 47 St,40.7448062877224,-73.91728967428207,17,16,33
W 17 St & 8 Ave,40.74177603,-74.00149746,23,46,69
Powers St & Olive St,40.71323,-73.93894,13,5,18
Carlton Ave & Flushing Ave,40.697787,-73.973736,34,12,46
48 Ave & 37 St,40.74034668087185,-73.92886072397232,5,14,19
Carlton Ave & Park Ave,40.69580705,-73.97355569,10,13,23
39 Ave & 54 St,40.74891,-73.90899,7,11,18
39 Ave & 56 St,40.74838,-73.90699,17,1,18
Peck Slip & South St,40.7075188830923,-74.00108054280281,20,23,43
9 Ave & W 204 St,40.86169883507865,-73.91855701804161,22,0,22
Skillman Ave & 54 St,40.745502,-73.909887,0,18,18
47 Ave & 48 St,40.74086,-73.91708,4,14,18
53 St & Roosevelt Ave,40.74462,-73.91143,9,10,19
39 Dr & 52 St,40.74732,-73.91197,5,10,15
Queens Blvd & 56 St,40.74193,-73.90913,9,7,16
57 St & 43 Ave,40.74324,-73.908,19,0,19
54 St & 37 Ave,40.75098,-73.90799,6,17,23
55 St & Northern Blvd,40.75326,-73.90585,6,15,21
W 24 St & 7 Ave,40.74487634,-73.99529885,19,56,75
Pleasant Ave & E 116 St,40.7949879,-73.9333349,21,1,22
President St & Henry St,40.6828003,-73.99990419,21,2,23
West Farms Rd & Boone Ave,40.8301283948092,-73.88630211353302,5,15,20
E 118 St & 3 Ave,40.799139,-73.9389152,24,4,28
21 St & 21 Ave,40.782465,-73.914527,4,15,19
21 St & 23 Ave,40.778557,-73.919046,8,14,22
39 Ave & 45 St,40.749478221834764,-73.91826465725897,17,1,18
State St & Smith St,40.68917,-73.9886,60,4,64
E 17 St & Broadway,40.73704984,-73.99009296,37,16,53
E 74 St & 1 Ave,40.7689738,-73.95482273,29,48,77
E 43 St & 2 Ave,40.75022392,-73.97121414,25,26,51
E 118 St & Park Ave,40.8005385,-73.9419949,18,7,25
Woodside Ave & 55 St,40.74679,-73.90893,7,11,18
57 St & 37 Ave,40.75048,-73.90513,3,19,22
61 St & Woodside Ave,40.74501,-73.9036,4,15,19
Woodside Ave & 60 St,40.74521,-73.90462,13,7,20
61 St & 39 Ave,40.7471,-73.9028,23,6,29
Carlton Ave & St Marks Ave,40.67911856082165,-73.97176265716553,17,8,25
E 72 St & Park Ave,40.77118287540658,-73.96409422159195,21,17,38
Grand St & Greene St,40.72170005235607,-74.00238141417502,6,33,39
30 St & 48 Ave,40.7413272,-73.937999,18,10,28
E 174 St & Longfellow Ave,40.836274,-73.884308,11,7,18
Sedgwick Ave & W Tremont Ave,40.85304455868985,-73.91830623149872,16,3,19
Keegan Rd & 2 Ave,40.64243139706092,-74.0255355834961,4,31,35
7 Ave & 62 St,40.63556,-74.01298,7,21,28
Broadway & Berry St,40.71036129922581,-73.96530389785767,17,17,34
Old Fulton St,40.70277159,-73.99383605,34,3,37
Plaza St East & Flatbush Ave,40.673134,-73.969106,32,27,59
Grand St & Elizabeth St,40.718822,-73.99596,21,21,42
W 46 St & 11 Ave,40.76341379,-73.99667444,17,3,20
8 Ave & W 49 St,40.76171227910671,-73.98655101656914,18,41,59
62 St & 34 Ave,40.75201,-73.89986,18,3,21
62 St & 43 Ave,40.74261,-73.903,6,13,19
60 St & 37 Ave,40.74958,-73.90256,15,3,18
37 Ave & 63 St,40.74893,-73.89981,11,10,21
65 St & 35 Ave,40.75053,-73.8977,11,14,25
Knickerbocker Ave & Moffat St,40.690434,-73.903737,3,20,23
35 St & 21 Ave,40.776745,-73.906558,7,16,23
31 St & Astoria Blvd,40.7699176,-73.9184057,24,7,31
35 St & 23 Ave,40.77301508291382,-73.91119033098221,3,23,26
65 Pl & Woodside Ave,40.74334,-73.89903,4,14,18
41 Ave & 67 St,40.74446,-73.89764,3,17,20
Bergen Ave & E 152 St,40.817166,-73.914737,14,7,21
65 St & Roosevelt Ave,40.74589,-73.89915,7,23,30
Nassau Ave & Newell St,40.724812564400175,-73.94752621650696,39,11,50
61 St & Queens Blvd,40.74091,-73.90273,25,1,26
61 St & Laurel Hill Blvd,40.7388,-73.90338,16,3,19
W 17 St & 7 Ave,40.740564236339516,-73.99852573871613,24,20,44
Church St & Worth St,40.71688538495366,-74.00650128722191,9,34,43
Jerome Ave & W Fordham Rd,40.86294,-73.90108,5,19,24
W 47 St & 9 Ave,40.76153045158114,-73.99007007479668,36,13,49
York St & Marin Blvd,40.716615000830494,-74.0424120426178,3,15,18
Broadway & W 138 St,40.82182,-73.95353,19,8,27
E 1 St & Bowery,40.72486122254819,-73.99213135242462,36,8,44
40 St & Queens Blvd,40.743540273428685,-73.92435193061829,11,11,22
W 45 St & 8 Ave,40.75929124,-73.98859651,24,39,63
Gramercy Park N & Gramercy Park E,40.73795,-73.98509,8,39,47
44 St & Greenpoint Ave,40.741119944681465,-73.92103672027588,10,17,27
W 55 St & 6 Ave,40.763189,-73.978434,2,72,74
Pearl St & York St,40.70140463410644,-73.98768022656441,7,46,53
W 56 St & 10 Ave,40.768254,-73.988639,23,19,42
E 47 St & Park Ave,40.75510267,-73.97498696,6,99,105
65 St & Broadway,40.749372273899596,-73.89738768339157,9,9,18
Woodside Ave & 69 St,40.7428,-73.89584,18,0,18
Malcolm X Blvd & DeKalb Ave,40.6938,-73.93114,6,13,19
Lewis Ave & Greene Ave,40.68995,-73.9365,19,4,23
2 Ave & 39 St,40.655722167971554,-74.01000827550888,48,0,48
Monroe St & Marcus Garvey Blvd,40.686722,-73.938988,5,15,20
Stuyvesant Ave & Gates Ave,40.68834,-73.93306,1,22,23
Madison St & Malcolm X Blvd,40.68713,-73.93008,21,3,24
Hancock St & Stuyvesant Ave,40.68454,-73.9322,10,7,17
Hancock St & Malcolm X Blvd,40.68487,-73.9293,18,1,19
Chauncey St & Stuyvesant Ave,40.68012,-73.93168,5,17,22
Putnam Ave & Ralph Ave,40.68705,-73.92338,15,4,19
Schermerhorn St & Hoyt St,40.6886263,-73.9851911,36,2,38
Chauncey St & Malcolm X Blvd,40.68044,-73.92842,3,20,23
Sumpter St & Fulton St,40.67923,-73.92588,5,14,19
E 165 St & Jerome Ave,40.83263,-73.925101,17,3,20
E 53 St & 3 Ave,40.75763227739443,-73.96930575370789,8,32,40
E 7 St & Ave C,40.72412944090093,-73.97901266813278,26,11,37
E 7 St & Ave B,40.7251285241158,-73.98131668567657,34,35,69
E 3 St & 1 Ave,40.72467721,-73.98783413,25,29,54
Schermerhorn St & Court St,40.6910363748993,-73.99201065301895,14,42,56
Riverside Dr & Broadway,40.865364,-73.92791,18,2,20
Thomas S. Boyland St & Macon St,40.68491,-73.91493,9,11,20
Halsey St & Ralph Ave,40.68494,-73.92299,17,2,19
Chauncey St & Howard Ave,40.68158,-73.91959,5,16,21
Featherbed Ln & Jerome Ave,40.845505,-73.914311,8,11,19
Townsend Ave & E 175 St,40.84741,-73.911359,15,3,18
Buchanan Pl & Grand Ave,40.85834,-73.90626,1,20,21
Crotona Park North & Prospect Ave,40.841092,-73.892317,14,5,19
E 7 St & Avenue A,40.72621788,-73.98379855,16,25,41
Thomas S. Boyland St & Marion St,40.6814658848122,-73.91415685415268,12,7,19
MacDougal St & Rockaway Ave,40.68018,-73.91136,4,16,20
Fulton St & Saratoga Ave,40.67853,-73.91642,10,9,19
Somers St & Rockaway Ave,40.67872,-73.91105,8,11,19
Thomas S. Boyland St & Fulton St,40.67854,-73.91367,1,23,24
Van Sinderen Ave & Atlantic Ave,40.67621,-73.90351,18,3,21
Pitt St & Stanton St,40.71926081,-73.98178024,14,1,15
St Marks Pl & 2 Ave,40.7284186,-73.98713956,30,42,72
W 190 St & St. Nicholas Ave,40.854788,-73.929513,19,8,27
Liberty St & Broadway,40.70905623,-74.01043382,30,34,64
College Ave & E 169 St,40.835122799036405,-73.91196817159653,10,8,18
E 19 St & 3 Ave,40.73624527,-73.98473765,6,26,32
E 58 St & 1 Ave (NE Corner),40.75892386377695,-73.96226227283478,17,10,27
E 58 St & 1 Ave (NW Corner),40.759125,-73.962658,18,22,40
JC Medical Center,40.71539114317,-74.04969155788422,3,17,20
Aqueduct Ave & W 190 St,40.8649213,-73.9024238,5,14,19
E 17 St & 2 Ave,40.73431166276575,-73.98372530937195,12,34,46
Prospect Pl & Nostrand Ave,40.67428,-73.9503,15,6,21
Brevoort Pl & Bedford Ave,40.68012,-73.95362,3,21,24
Lafayette Ave & Stuyvesant Ave,40.6919925157634,-73.9325501024723,4,19,23
Cauldwell Ave & E 158 St,40.81989,-73.908351,10,7,17
MacDonough St & Malcolm X Blvd,40.68273,-73.92926,9,10,19
Eastern Pkwy & Kingston Ave,40.66959,-73.94237,21,8,29
Pacific St & Nostrand Ave,40.6776,-73.94963,4,17,21
E 32 St & Park Ave,40.7457121,-73.98194829,8,47,55
Whitehall St & Bridge St,40.703661705241345,-74.0131813287735,10,31,41
Sterling Pl & New York Ave,40.67234,-73.94763,23,1,24
Stuyvesant Ave & Hart St,40.69465,-73.9343,16,9,25
Ralph Ave & Fulton St,40.67922,-73.92192,15,10,25
MacDonough St & Marcy Ave,40.68078,-73.94613,9,11,20
New York Ave & St Marks Ave,40.67514,-73.94716,8,15,23
Herkimer St & New York Ave,40.67955,-73.94709,20,4,24
Brooklyn Ave & Prospect Pl,40.67412,-73.94447,21,4,25
Kingston Ave & Park Pl,40.67308,-73.94191,8,13,21
St. Johns Pl & Kingston Ave,40.67113,-73.94222,11,9,20
6 St & 7 Ave,40.6686627,-73.97988067,15,4,19
9 Ave & W 39 St,40.756403523272496,-73.99410143494606,16,18,34
Knickerbocker Ave & Hancock St,40.69385,-73.90974,8,12,20
Decatur St & Saratoga Ave,40.68332,-73.91711,7,13,20
Bergen St & Kingston Ave,40.6756,-73.9415,12,9,21
Bergen St & Troy Ave,40.67524,-73.93596,3,18,21
Pacific St & Troy Ave,40.67686,-73.93607,3,17,20
Schenectady Ave & Prospect Pl,40.67351,-73.93363,9,10,19
Pacific St & Utica Ave,40.6767,-73.93051,17,3,20
Eastern Pkwy & Troy Ave,40.66929,-73.93679,20,4,24
River Ter & Warren St,40.71759894980997,-74.01587963104248,11,56,67
E 15 St & 3 Ave,40.734232,-73.986923,22,38,60
Main St & Plymouth St,40.703781673548306,-73.99073392152786,27,15,42
Macon St & Howard Ave,40.68452,-73.92011,13,4,17
Pacific St & Rochester Ave,40.67639,-73.92748,8,9,17
St Johns Pl & Utica Ave,40.6705,-73.9308,1,20,21
Macon St & Patchen Ave,40.68374,-73.9261,10,9,19
Park Pl & Utica Ave,40.67242,-73.93094,10,11,21
St Marks Ave & Rochester Ave,40.67404,-73.92772,5,12,17
6 Ave & W 34 St,40.74964,-73.98805,12,53,65
Eastern Pkwy & Rochester Ave,40.66846,-73.9282,15,9,24
Sterling Pl & Schenectady Ave,40.6716,-73.93378,12,5,17
6 Ave & W 45 St,40.756951,-73.982631,13,54,67
Macon St & Lewis Ave,40.68282,-73.93488,16,2,18
Bergen St & Buffalo Ave,40.6747,-73.92512,5,15,20
Sterling Pl & Rochester Ave,40.67128,-73.92825,3,18,21
Park Pl & Buffalo Ave,40.67202,-73.92539,10,10,20
St Marks Ave & Ralph Ave,40.67372,-73.92199,3,15,18
Classon Ave & St Marks Ave,40.676513,-73.959431,9,16,25
Prospect Pl & Howard Ave,40.67261,-73.91977,10,7,17
Market St & Henry St,40.71310702305908,-73.99446353316307,37,4,41
Central Park West & W 72 St,40.77579376683666,-73.9762057363987,43,5,48
Central Park West & W 68 St,40.7734066,-73.97782542,41,2,43
31 St & Thomson Ave,40.74469738,-73.93540375,15,31,46
8 St & Washington St,40.745983882915624,-74.02819901704788,5,12,17
Columbus Park - Clinton St & 9 St,40.74816121065146,-74.0324530005455,7,15,22
Howard St & Lafayette St,40.71910537,-73.99973337,7,19,26
W 82 St & Central Park West,40.78275,-73.97137,24,18,42
Buffalo Ave & St Johns Pl,40.67015,-73.92538,12,9,21
Eastern Pkwy & Ralph Ave,40.66852,-73.92284,13,7,20
Central Park West & W 76 St,40.77896784,-73.97374737,20,18,38
Sterling Pl & Ralph Ave,40.67095,-73.92222,12,7,19
Greenwich St & Rector St,40.70806582380646,-74.0135595202446,33,7,40
Bergen St & Saratoga Ave,40.67423,-73.91656,2,18,20
Pacific St & Thomas S. Boyland St,40.67568,-73.91396,10,10,20
Herkimer St & Eastern Pkwy,40.67738,-73.90829,9,9,18
Macombs Pl & W 152 St,40.826406,-73.937948,28,5,33
2 Ave & 43 St,40.65292829363811,-74.01286482810974,17,2,19
Wyckoff St & 3 Ave,40.6827549,-73.98258555,19,3,22
Underhill Ave & Pacific St,40.6804836,-73.9646795,19,8,27
E 4 St & Ave B,40.723346832180155,-73.98265913128853,29,6,35
E 6 St & 2 Ave,40.727378693232225,-73.98840844631195,37,31,68
Columbus Pl & Atlantic Ave,40.67717,-73.92285,4,17,21
Park Pl & Thomas S. Boyland St,40.67154,-73.91433,20,3,23
3 Ave & 14 St,40.6685455,-73.99333264,22,2,24
Fulton St & Adams St,40.692418292578466,-73.98949474096298,4,40,44
Troy Ave & Park Pl,40.67251,-73.93642,4,17,21
Pearl St & Hanover Square,40.7047177,-74.00926027,40,24,64
Grove St PATH,40.71941,-74.04309,6,6,12
Lexington Ave & Stuyvesant Ave,40.68973,-73.93353,6,14,20
Schenectady Ave & Pacific St,40.67686,-73.93327,19,0,19
Carroll St & Rochester Ave,40.66598,-73.9284,6,15,21
Bergen St & Mother Gaston Blvd,40.67374,-73.90852,19,3,22
Pacific St & Smith St,40.687880939612775,-73.98939281702042,27,19,46
Buffalo Ave & E New York Ave,40.66591,-73.92602,23,0,23
St Johns Pl & Howard Ave,40.66992,-73.92002,11,10,21
St Marks Ave & Thomas S. Boyland St,40.67313,-73.91387,20,1,21
Dean St & Rockaway Ave,40.67486,-73.91123,3,18,21
Tompkins Ave & Hopkins St,40.69957608,-73.94708417,11,6,17
Putnam Ave & Nostrand Ave,40.68402,-73.94977,14,5,19
Pier 40 - Hudson River Park,40.7277140777778,-74.01129573583603,8,9,17
69 St & 38 Ave,40.74694504524519,-73.89650255441666,13,11,24
64 St & 51 Ave,40.73577,-73.90184,6,13,19
E 5 St & Cooper Sq,40.72769,-73.990993,39,11,50
33 St & Queens Blvd,40.7443653191867,-73.93172398209572,7,16,23
51 Ave & 61 St,40.73568,-73.90387,19,0,19
Tyler Ave & Maurice Ave,40.73394,-73.90128,14,4,18
Broadway & W 122 St,40.8120562,-73.9612547,10,22,32
Washington Ave & E 167 St,40.829896,-73.907618,2,16,18
Myrtle Ave & 65 St,40.70117,-73.8904,16,2,18
E 76 St & Park Ave,40.773763,-73.96222088,16,10,26
65 St & Otto Rd,40.70389,-73.89116,17,2,19
Cypress Hills St & Otto Rd,40.70204,-73.89288,12,6,18
55 Dr & Maurice Ave,40.7261,-73.90917,14,3,17
Bleecker St & Forest Ave,40.7107,-73.90525,7,10,17
Ave C & E 16 St,40.72984830346529,-73.97455215454102,17,11,28
60 Pl & Linden St,40.70886,-73.90182,17,3,20
71 Ave & Myrtle Ave,40.70067,-73.89907,9,18,27
E 58 St & 3 Ave,40.76095756,-73.96724467,7,38,45
Summerfield St & Cypress Ave,40.69662,-73.90056,7,12,19
Wyckoff Ave & Cooper Ave,40.69338,-73.90061,0,15,15
E 56 St & 3 Ave,40.75934501,-73.96759673,8,69,77
Amory Ct & Metropolitan Ave,40.71301,-73.90968,17,4,21
St Felix Ave & 61 St,40.69715,-73.8936,15,3,18
Metropolitan Ave & Flushing Ave,40.71334,-73.91572,16,3,19
Hudson Blvd W & W 36 St,40.75676475086503,-73.99971440439913,11,36,47
67 Ave & Fresh Pond Rd,40.70575,-73.89676,11,17,28
Cooper Ave & 65 Pl,40.69953,-73.88873,16,4,20
E 2 St & 2 Ave,40.72502876,-73.99069656,62,17,79
60 St & 60 Rd,40.71592232709503,-73.90601366758347,18,1,19
59 St & 59 Rd,40.71790852734058,-73.908454477787,9,12,21
64 St & Woodbine St,40.70809,-73.89549,10,7,17
Fresh Pond Rd & Eliot Ave,40.71453,-73.90105,16,4,20
57 St & Grand Ave,40.71921,-73.9124,15,3,18
Page Pl & Grand Ave,40.71798,-73.91818,12,9,21
57 Rd & 58 St,40.72235,-73.91215,20,1,21
63 St & 59 Dr,40.71832,-73.90128,11,10,21
E 43 St & Madison Ave,40.75354681867074,-73.97896572947502,3,51,54
Amsterdam Ave & W 82 St,40.78524672,-73.97667321,7,30,37
60 Pl & 67 Ave,40.70497,-73.89965,4,10,14
53 St & Flushing Ave,40.71435,-73.91405,1,18,19
Fresh Pond Rd & 69 Ave,40.70311,-73.89547,14,14,28
Maurice Ave & 53 Dr,40.73028,-73.90421,14,1,15
Fresh Pond Rd & Flushing Ave,40.72155,-73.90295,13,6,19
56 Dr & 61 St,40.72368,-73.90458,16,1,17
56 Dr & 59 St,40.72403,-73.90853,19,0,19
57 Rd & 59 St,40.72249,-73.90854,11,8,19
60 Ave & Fresh Pond Rd,40.71693,-73.90198,17,2,19
Catalpa Ave & Woodward Ave,40.70229,-73.90145,8,9,17
Grand Ave & 55 St,40.71888,-73.91427,11,7,18
Cypress Ave & St Felix Ave,40.69559,-73.89927,11,10,21
Palmetto St & Traffic Ave,40.70929,-73.89441,4,17,21
Metropolitan Ave & 65 Ln,40.71225,-73.89111,24,0,24
64 St & 53 Dr,40.72897,-73.90115,18,0,18
Seneca Ave & Decatur St,40.69723,-73.89811,6,14,20
Grand Ave & Remsen Pl,40.72353,-73.89967,18,3,21
Eastern Pkwy & Brooklyn Ave,40.66939,-73.94514,10,10,20
Eastern Pkwy & Schenectady Ave,40.66876,-73.93376,5,19,24
Eastern Pkwy & Nostrand Ave,40.66967,-73.9503,17,10,27
Kingston Ave & Carroll St,40.66688,-73.9425,6,12,18
Empire Blvd & New York Ave,40.66403,-73.94769,13,9,22
Albany Ave & Carroll St,40.6667,-73.93972,12,6,18
Sterling St & Nostrand Ave,40.66318,-73.95076,21,1,22
Kingston Ave & Montgomery St,40.66481,-73.94269,6,12,18
Carroll St & Utica Ave,40.66619,-73.93162,16,3,19
Rogers Ave & Lincoln Rd,40.66127,-73.95352,20,3,23
Maple St & Flatbush Ave,40.66026,-73.96045,17,7,24
Bedford Ave & Maple St,40.66035,-73.95679,21,0,21
2 St & Park Ave,40.73915272763701,-74.0330819785595,5,8,13
Flatbush Ave & Fenimore St,40.65798,-73.96051,24,0,24
Lincoln Rd & Ocean Ave,40.6605,-73.9626,21,1,22
Parkside Ave & Flatbush Ave,40.65563,-73.95968,24,0,24
Nostrand Ave & Rutland Rd,40.6595,-73.95041,19,0,19
Bedford Ave & Clarkson Ave,40.65519,-73.9564,17,3,20
Winthrop St & Nostrand Ave,40.65707,-73.95005,24,0,24
Bedford Ave & Fenimore St,40.65815,-73.95674,17,3,20
Crown St & Rogers Ave,40.66639,-73.95346,11,8,19
Schenectady Ave & President St,40.66732,-73.93398,4,17,21
Patchen Ave & Bainbridge St,40.68143,-73.92565,3,16,19
Winthrop St & Rogers Ave,40.65686,-73.95331,9,11,20
Maple St & New York Ave,40.66104,-73.94795,21,1,22
New York Ave & Hawthorne St,40.65794,-73.94735,18,2,20
Maple St & Albany Ave,40.66155,-73.93974,15,0,15
W 25 St & 9 Ave,40.747832605837715,-74.0005722643582,27,38,65
W 20 St & 5 Ave,40.73972989238724,-73.99103969335556,12,45,57
E New York Ave & Troy Ave,40.66227,-73.93762,19,2,21
Midwood St & Utica Ave,40.66124,-73.93164,19,2,21
Schenectady Ave & Maple St,40.66178,-73.93445,18,0,18
Rutland Rd & E 45 St,40.66034,-73.93618,16,7,23
Clarkson Ave & Utica Ave,40.65666,-73.93109,14,6,20
Lewis Ave & Fulton St,40.67972,-73.93467,5,15,20
Fulton St & Williams Ave,40.67709,-73.9008,17,3,20
Degraw St & 3 Ave,40.67977,-73.9847,33,2,35
50 Ave & 65 St,40.73707,-73.90077,14,5,19
56 St & Arnold Ave,40.71484,-73.909,16,3,19
Eliot Ave & 60 Ln,40.71391,-73.90299,15,6,21
57 St & 7 Ave,40.638566,-74.010147,8,13,21
Walton Ave & E 176 St,40.84833,-73.90971,22,0,22
Lafayette St & Grand St,40.72028,-73.99879,43,30,73
Exchange Pl,40.71636596185077,-74.034343957901,4,26,30
23 St & 31 Ave,40.76663971723091,-73.9286595582962,16,3,19
Pacific St & Ralph Ave,40.67607,-73.92171,7,13,20
Goble Pl & Macombs Rd,40.844075,-73.917256,18,0,18
E 81 St & 1 Ave,40.77377781072322,-73.95197331905365,17,11,28
Wythe Ave & N 13 St,40.722767,-73.957021,32,10,42
7 Ave & W 55 St,40.764126,-73.980973,11,54,65
W 54 St & 6 Ave,40.761865,-73.977242,7,56,63
Greenpoint Ave & West St,40.729803,-73.959099,29,5,34
Driggs Ave & S 2 St,40.712628,-73.960575,18,11,29
31 Ave & 30 St,40.7647,-73.9240312,17,4,21
Ash St & Manhattan Ave,40.738095,-73.954867,23,6,29
N 5 St & Wythe Ave,40.718389,-73.961501,31,8,39
Eagle St & Manhattan Ave,40.735217,-73.954926,35,0,35
N 7 St & Driggs Ave,40.716967,-73.956388,40,11,51
S 2 St & Kent Ave,40.714731,-73.966612,34,10,44
57 St & Woodside Ave,40.74578861252213,-73.9072778339874,11,8,19
N 5 St & Northside Piers,40.719876,-73.963865,26,18,44
Broadway & Kent Ave,40.710888,-73.968329,27,8,35
S 4 St & Roebling St,40.710709,-73.959724,9,26,35
21 St & Hoyt Ave S,40.774645,-73.923706,7,25,32
Scholes St & Lorimer St,40.708323,-73.948732,16,7,23
Seaman Ave & Isham St,40.869898661940454,-73.92076313495636,20,1,21
Monitor St & Meeker Ave,40.721226,-73.941845,14,3,17
N Henry St & Norman Ave,40.7277,-73.94395,17,12,29
E 77 St & 1 Ave,40.77095553869235,-73.95356208096926,25,25,50
W 171 St & St. Nicholas Ave,40.842941,-73.938631,14,17,31
48 St & Barnett Ave,40.750016404259334,-73.91540944576263,15,3,18
N 10 St & Berry St,40.720253,-73.957082,20,24,44
Audubon Ave & Fort George Ave,40.85715781391904,-73.92717361450195,4,19,23
Manhattan Ave & Devoe St,40.713532,-73.9459867,18,6,24
Norman Ave & Leonard St,40.725819,-73.950815,22,9,31
Greenpoint Ave & Monitor St,40.73224,-73.94383,2,17,19
Fulton St & Waverly Ave,40.683238654603414,-73.96599590778351,25,5,30
Longfellow Ave & Aldus St,40.82319448542357,-73.88762910982096,12,10,22
65 Ln & Metropolitan Ave,40.7123,-73.89397,18,5,23
Greenpoint Ave & 47 St,40.7424,-73.91808,6,13,19
W 186 St & St. Nicholas Ave,40.852253,-73.931308,3,23,26
Caton Ave & Argyle Rd,40.649681,-73.967829,19,1,20
63 St & Borden Ave,40.72655,-73.90321,14,7,21
Hudson St & Reade St,40.71625008,-74.0091059,8,44,52
Flatbush Ave & Lincoln Rd,40.66131,-73.96091,7,15,22
58 St & 56 Dr,40.72419,-73.91244,9,10,19
Pacific St & Sackman St,40.67522,-73.9061,3,16,19
Clarkson Ave & Nostrand Ave,40.6555,-73.94975,14,10,24
South End Ave & Albany St,40.709957,-74.016538,21,23,44
President St & Nostrand Ave,40.66811,-73.9505,17,11,28
W 170 St & University Ave,40.84207,-73.926075,4,16,20
Grove St & Fresh Pond Rd,40.71032,-73.89955,7,12,19
60 Pl & Flushing Ave,40.71988,-73.90556,17,2,19
Fort Washington Ave & W 183 St,40.852252,-73.937854,7,20,27
60 Pl & Bleecker St,40.71107,-73.903,4,15,19
W 27 St & 6 Ave,40.74526,-73.99062,28,28,56
Melrose St & Broadway,40.697481,-73.935877,9,10,19
W 43 St & 6 Ave,40.75527307,-73.98316936,6,54,60
Carmine St & 6 Ave,40.73038599,-74.00214988,46,13,59
Bedford Ave & Nassau Ave,40.72311651,-73.95212324,36,8,44
Pinehurst Ave & W 187 St,40.855331,-73.937878,10,8,18
Greenwich Ave & 8 Ave,40.7390169121,-74.0026376103,53,17,70
Greenwich Ave & Charles St,40.735238,-74.000271,21,35,56
Washington Ave & Empire Blvd,40.66314,-73.9605695,10,16,26
Sheridan Ave & E 168 St,40.835334,-73.9154,7,13,20
61 St & Borden Ave,40.72558,-73.90417,21,0,21
E 85 St & York Ave,40.77536905,-73.94803392,20,23,43
10 St & 4 Ave,40.66967356370341,-73.98898908183764,23,7,30
Kent Ave & Division Ave,40.706563674670925,-73.9683187007904,32,9,41
Little West St & 1 Pl,40.70569254,-74.01677685,14,19,33
Kent Ave & Grand St,40.716425,-73.96594,39,5,44
Kent Ave & N 7 St,40.72036775298455,-73.96165072917938,51,2,53
Front St & Jay St,40.702461,-73.986842,7,13,20
Edgecombe Ave & W 167 St,40.838191,-73.936085,9,11,20
Bleecker St & Crosby St,40.72615604980408,-73.99510189890862,34,27,61
Johnson St & Brooklyn Bridge Blvd,40.695,-73.98917,16,14,30
W 51 St & Rockefeller Plaza,40.75973805251143,-73.97811613976955,4,45,49
W 25 St & 8 Ave,40.74649996333341,-73.99732626293645,14,41,55
W 163 St & Edgecombe Ave,40.835798,-73.937496,4,13,17
E 14 St & 1 Ave,40.73139303364151,-73.98286700248718,25,9,34
Broadway & W 29 St,40.7462009,-73.98855723,21,73,94
Van Dam St & Meeker Ave,40.72532,-73.9368,12,9,21
Bond St & Fulton St,40.6896218879,-73.9830426872,37,10,47
Vernon Blvd & 41 Rd,40.7552433,-73.9485678,23,4,27
W 4 St & 7 Ave S,40.73401143,-74.00293877,11,8,19
Lafayette Ave & Ft Greene Pl,40.68700231292619,-73.97664964199066,32,1,33
Brooklyn Ave & Dean St,40.67669,-73.94437,10,9,19
Lefferts Ave & Schenectady Ave,40.66343,-73.93472,25,2,27
N 9 St & Wythe Ave,40.72054,-73.959,24,6,30
Calyer St & West St,40.72693,-73.95863,30,2,32
Riverside Dr & W 82 St,40.78720869,-73.98128127,55,19,74
W 78 St & Broadway,40.78339981,-73.98093133,29,6,35
Broadway & Battery Pl,40.70463334,-74.01361706,9,38,47
W 63 St & Broadway,40.77163851,-73.98261428,21,9,30
E 117 St & 1 Ave,40.796568260802964,-73.93459528684616,10,10,20
E 39 St & 2 Ave,40.748033194287665,-73.973827958107,27,3,30
W 52 St & 5 Ave,40.75992262,-73.97648516,15,43,58
Madison Ave & E 82 St,40.7781314,-73.96069399,11,18,29
E 78 St & 2 Ave,40.7727966,-73.95577801,6,19,25
Parkside Ave & Ocean Ave,40.65485,-73.96217,27,0,27
Parkside Ave & Parade Pl,40.6532,-73.96639,21,0,21
Caton Ave & Bedford Ave,40.65237,-73.95623,18,2,20
50 St & 7 Ave,40.642501,-74.006055,11,10,21
Linden Blvd & Nostrand Ave,40.65272,-73.94994,22,1,23
Rogers Ave & Lenox Rd,40.65378,-73.95273,15,6,21
Gansevoort St & Hudson St,40.73937600789778,-74.00520807425661,20,98,118
Clarkson Ave & Troy Ave,40.65633,-73.93648,20,3,23
Lenox Rd & E 43 St,40.65496,-73.93765,12,8,20
Clarkson Ave & E 37 St,40.65577,-73.9432,9,10,19
Troy Ave & Linden Blvd,40.6533,-73.93644,13,10,23
E 21 St & Church Ave,40.65007,-73.96001,22,1,23
Rugby Rd & Albemarle Rd,40.64672,-73.96637,19,0,19
Rugby Rd & Beverley Rd,40.64435,-73.96591,24,0,24
E 17 St & Beverley Rd,40.64466,-73.96322,20,1,21
2 Ave & E 99 St,40.7862586,-73.94552579,19,12,31
E 18 St & Church Ave,40.64958,-73.96316,26,4,30
Albemarle Rd & E 21 St,40.64741,-73.95933,19,0,19
E 34 St & Linden Blvd,40.65302,-73.94599,17,7,24
E 91 St & Park Ave,40.7835016,-73.955327,12,16,28
Rogers Ave & Snyder Ave,40.64871,-73.95218,18,4,22
Church Ave & Nostrand Ave,40.65074,-73.94986,20,7,27
Church Ave & E 42 St,40.65127,-73.93818,19,4,23
Tilden Ave & Nostrand Ave,40.64683,-73.94933,15,7,22
Brooklyn Ave & Tilden Ave,40.64725,-73.94352,24,0,24
Brooklyn Ave & Snyder Ave,40.64915,-73.94368,8,13,21
Matthews Ct & Coney Island Ave,40.64235,-73.96951,15,5,20
Tilden Ave & Lott St,40.64661,-73.95401,13,4,17
W 18 St & 9 Ave,40.7435337324616,-74.00367558002472,5,32,37
Beverley Rd & Flatbush Ave,40.64499,-73.95818,30,0,30
W 52 St & 11 Ave,40.76727216,-73.99392888,27,24,51
New York Ave & Montgomery St,40.66509,-73.94824,17,2,19
Ocean Ave & Tennis Ct,40.64873,-73.96084,23,0,23
23 Ave & 31 St,40.77423301703027,-73.91274864321404,4,22,26
Lott St & Erasmus St,40.64949,-73.95408,18,1,19
New York Ave & Snyder Ave,40.64868,-73.94635,19,3,22
Cortelyou Rd & Stratford Rd,40.63966,-73.96807,20,0,20
E 16 St & Cortelyou Rd,40.64173,-73.96364,16,5,21
Cortelyou Rd & Argyle Rd,40.64034,-73.96603,20,1,21
Ditmars Blvd & 73 St,40.76817,-73.896293,14,5,19
Ditmars Blvd & 76 St,40.768442,-73.893531,16,3,19
Cortelyou Rd & E 19 St,40.64269,-73.96099,17,5,22
Bedford Ave & Beverley Rd,40.64491,-73.95487,21,2,23
Driggs Ave & N Henry St,40.72325,-73.94308,18,32,50
Cortelyou Rd & E 34 St,40.64454,-73.94486,17,1,18
Brooklyn Ave & Beverley Rd,40.64575,-73.94331,19,0,19
Carlton Ave & Dean St,40.6809741,-73.9710097,21,6,27
48 St & 37 Ave,40.751555,-73.915026,19,9,28
W 74 St & Columbus Ave,40.7785669,-73.97754961,10,16,26
Ocean Ave & Crooke Ave,40.65326,-73.96172,19,6,25
Bedford Ave & Albemarle Rd,40.64796,-73.9556,20,1,21
New York Ave & Lenox Rd,40.65458,-73.94716,15,8,23
Cortelyou Rd & Albany Ave,40.64483,-73.93853,17,2,19
E 48 St & Tilden Ave,40.64795,-73.93182,21,0,21
Beverley Rd & Nostrand Ave,40.64507,-73.9488,13,8,21
Turner Pl & Coney Island Ave,40.64521,-73.97073,14,4,18
Beverley Rd & E 49 St,40.64621,-73.93067,20,0,20
Schenectady Ave & Cortelyou Rd,40.64535,-73.93268,19,3,22
W 35 St & 9 Ave,40.75414519263519,-73.9960889518261,25,6,31
21 Ave & 80 St,40.770888,-73.889914,14,3,17
Ditmars Blvd & 19 St,40.78145,-73.9183302,13,14,27
71 St & 37 Ave,40.7488,-73.89451,7,16,23
34 Ave & 71 St,40.75257,-73.89538,22,0,22
72 St & Northern Blvd,40.75473,-73.89458,16,1,17
Ashland Pl & Dekalb Ave,40.690065,-73.978776,42,5,47
3 Ave & E 109 St,40.79338,-73.94329,18,6,24
14 St Ferry - 14 St & Shipyard Ln,40.752960630464955,-74.02435272932053,3,28,31
34 Ave & 74 St,40.75297,-73.89236,15,9,24
32 Ave & 75 St,40.75704,-73.8924,19,0,19
71 St & 32 Ave,40.75675,-73.89595,17,1,18
Winthrop St & Schenectady Ave,40.6582,-73.9338,18,3,21
Winthrop St & Albany Ave,40.6577,-73.9398,20,1,21
81 St & 35 Ave,40.75179,-73.88568,15,8,23
74 St & 37 Ave,40.74908,-73.89172,11,17,28
77 St & 31 Ave,40.75886,-73.89081,19,1,20
77 St & 24 Ave,40.76428,-73.89156,17,1,18
73 St & 25 Ave,40.76205,-73.895,18,1,19
81 St & 24 Ave,40.76466,-73.88803,16,2,18
61 St & 60 Ln,40.70055,-73.8943,5,12,17
81 St & 34 Ave,40.75374,-73.88604,14,10,24
32 Ave & 81 St,40.75763,-73.88682,19,0,19
82 St & 30 Ave,40.76109,-73.88632,15,4,19
86 St & 37 Ave,40.75,-73.88062,1,20,21
84 St & Roosevelt Ave,40.74797,-73.88204,12,17,29
92 St & 35 Ave,40.7529,-73.87536,18,8,26
Suydam St & Knickerbocker Ave,40.702013,-73.923769,26,1,27
W 84 St & Amsterdam Ave,40.78621,-73.9756,49,10,59
86 St & 35 Ave,40.7523,-73.88093,12,8,20
32 Ave & 84 St,40.75793,-73.88401,9,8,17
Sterling Pl & Franklin Ave,40.67324785,-73.95689517,4,14,18
Amsterdam Ave & W 119 St,40.80863218,-73.9595861,4,24,28
Freeman St & Reverend James A Polite Ave,40.830529,-73.894717,14,5,19
Freeman St & Southern Blvd,40.830051,-73.892103,21,2,23
Walton Ave & E 153 St,40.822351,-73.926907,13,6,19
79 St & 37 Ave,40.74937,-73.88714,8,12,20
Union Ave & E 169 St,40.82995,-73.898802,7,11,18
87 St & 30 Ave,40.76156,-73.88167,18,2,20
85 St & Northern Blvd,40.75601,-73.88266,3,18,21
25 Ave & 85 St,40.76328,-73.88404,10,8,18
Walton Ave & E 151 St,40.82090903827738,-73.92753845245076,8,20,28
River St & 1 St,40.73721535335381,-74.02886540972803,0,23,23
90 St & 32 Ave,40.75836,-73.87824,9,9,18
24 Ave & 87 St,40.7654,-73.88256,16,3,19
88 St & Astoria Blvd,40.76424,-73.8812,10,10,20
92 St & 37 Ave,40.75085,-73.87509,3,16,19
E 94 St & Madison Ave,40.785851052913884,-73.95482444378061,13,24,37
Elmhurst Ave & Roosevelt Ave,40.74864,-73.87619,4,17,21
93 St & Roosevelt Ave,40.74888,-73.87368,1,23,24
30 Ave & 96 St,40.76086,-73.87308,13,7,20
W 27 St & 7 Ave,40.746647,-73.993915,6,43,49
96 St & Northern Blvd,40.75712,-73.8722,10,9,19
Warren St & Roosevelt Ave,40.74919,-73.87043,18,11,29
31 Ave & 86 St,40.75958,-73.88219,6,13,19
92 St & Astoria Blvd,40.76313,-73.8772,9,9,18
Berry St & N 8 St,40.7190095,-73.95852515,17,7,24
24 Ave & 92 St,40.76589,-73.87789,7,13,20
91 St & 23 Ave,40.76769,-73.8791,3,18,21
98 St & 25 Ave,40.76454,-73.87171,17,2,19
Ditmars Blvd & 94 St,40.7702,-73.87587,3,16,19
Jackson Mill Rd & 24 Ave,40.76619,-73.87561,13,11,24
Grand Ave & 58 Ave,40.72098,-73.90701,18,2,20
Essex Light Rail,40.7127742,-74.0364857,0,22,22
100 St & Northern Blvd,40.75748,-73.86843,2,19,21
99 St & Astoria Blvd,40.76196,-73.87042,22,0,22
E 34 St & Church Ave,40.65116,-73.94577,23,2,25
Snyder Ave & Schenectady Ave,40.65,-73.93296,18,1,19
99 St & 32 Ave,40.75896,-73.86976,13,5,18
32 Ave & 77 St,40.75727,-73.89024,22,0,22
99 St & 38 Ave,40.75055,-73.86725,16,13,29
99 St & 35 Ave,40.75404,-73.86887,13,4,17
100 St & 37 Ave,40.75243,-73.86717,7,12,19
23 Ave & 83 St,40.76646,-73.88674,11,8,19
104 St & 38 Ave,40.75138,-73.86242,11,8,19
104 St & Northern Blvd,40.75755,-73.86454,4,18,22
108 St & 39 Ave,40.75165,-73.85915,20,1,21
31 Ave & 103 St,40.76134,-73.86666,9,11,20
Gillmore St & 27 Ave,40.76399,-73.8669,17,1,18
100 St & Humphreys St,40.76574,-73.87012,12,9,21
Ditmars Blvd & 102 St,40.76894,-73.86832,15,10,25
Nevins St & Schermerhorn St,40.68737247650719,-73.98176059126854,23,4,27
97 St & 23 Ave,40.7683,-73.87331,4,15,19
Butler St & 27 Ave,40.76521,-73.86483,16,1,17
111 St & 37 Ave,40.75397,-73.85748,16,5,21
112 St & Northern Blvd,40.75788,-73.85763,5,15,20
107 St & 32 Ave,40.75996,-73.86224,13,4,17
Eastern Pkwy & Washington Ave,40.6716493,-73.9631145,19,9,28
87 St & Roosevelt Ave,40.74825,-73.87936,0,23,23
Eastern Pkwy & Franklin Ave,40.6707767,-73.9576801,30,11,41
34 Ave & 83 St,40.75375,-73.88423,7,13,20
72 St & Broadway,40.74751,-73.89372,1,17,18
Flatbush Ave & Eastern Pkwy,40.668757,-73.966438,14,16,30
Jackson Mill Rd & 93 St,40.75874,-73.87535,13,8,21
91 St & 31 Ave,40.76022,-73.87774,9,12,21
30 Ave & 80 St,40.76109,-73.88838,16,3,19
West Drive & Prospect Park West,40.6610633719006,-73.97945255041122,12,15,27
8 Ave & W 33 St,40.751551,-73.993934,38,53,91
34 Ave & Junction Blvd,40.75502,-73.87285,3,20,23
95 St & 35 Ave,40.75301,-73.87266,3,20,23
93 St & Northern Blvd,40.7564,-73.87504,10,12,22
34 Ave & 113 St,40.75696,-73.85612,20,3,23
5 Ave & E 30 St,40.7459849,-73.98629487,29,17,46
37 Ave & 106 St,40.75397,-73.862,7,10,17
37 Ave & 113 St,40.75475,-73.8549,23,0,23
114 St & 39 Ave,40.7532,-73.853,17,12,29
34 Ave & 108 St,40.75614,-73.86084,8,15,23
25 Ave & 96 St,40.76447,-73.87369,7,14,21
Kingston Ave & E New York Ave,40.66219,-73.94293,17,3,20
Spruce St & Nassau St,40.71146364,-74.00552427,0,18,18
Lefferts Ave & Albany Ave,40.66288,-73.94019,19,5,24
Crown St & Troy Ave,40.66559,-73.93712,15,4,19
E 19 St & Beverley Rd,40.64483,-73.9613,17,2,19
41 Ave & 77 St,40.74557,-73.8882,7,17,24
75 St & Roosevelt Ave,40.7468,-73.89038,6,22,28
4 St & River St,40.7408139,-74.0274062,3,9,12
Adams St & 12 St,40.751889392240685,-74.03329162748534,7,7,14
Benham St & Roosevelt Ave,40.74841,-73.8751,20,3,23
Ithaca St & Baxter Ave,40.74638,-73.88322,5,20,25
76 St & 45 Ave,40.7411,-73.88837,8,11,19
South Railroad Ave & Broadway,40.741,-73.88027,18,5,23
St James Ave & 51 Ave,40.73813,-73.88104,14,7,21
Queens Blvd & Albion Ave,40.73856,-73.88553,13,8,21
Morton St & Washington St,40.73115,-74.00887,28,2,30
Jefferson Ave & Patchen Ave,40.68609,-73.92628,17,2,19
Case St & 94 St,40.74619,-73.87193,3,17,20
Queens Blvd & Broadway,40.73672,-73.87728,18,6,24
Forley St & Lamont Ave,40.74463,-73.87386,10,10,20
Brooklyn Ave & Lefferts Ave,40.662564,-73.945565,20,0,20
East End Ave & E 86 St,40.77518615,-73.94446054,21,6,27
Corona Ave & 90 St,40.74154,-73.87484,6,15,21
90 St & 51 Ave,40.73937,-73.87411,5,14,19
E 31 St & 3 Ave,40.74394314,-73.97966069,48,11,59
55 Ave & 90 St,40.73676,-73.87318,21,0,21
46 Ave & Junction Blvd,40.74399,-73.86781,13,6,19
51 Ave & Junction Blvd,40.74087,-73.86772,5,14,19
Queens Blvd & 56 Ave,40.73481,-73.87431,15,24,39
W 33 St & 10 Ave,40.753773368360385,-73.99937599897385,11,49,60
Madison Ave & E 99 St,40.78948541553215,-73.95242929458618,6,27,33
94 St & 57 Ave,40.73628,-73.86752,4,21,25
Adam Clayton Powell Blvd & W 126 St,40.809495347779475,-73.94776493310928,29,4,33
56 Ave & Junction Blvd,40.73716,-73.86625,0,22,22
E 161 St & River Ave,40.827883,-73.927111,4,29,33
53 Ave & 94 St,40.73921,-73.86887,2,18,20
E 167 St & Bryant Ave,40.826706,-73.888719,0,20,20
58 St & 32 Ave,40.75574,-73.903427,7,12,19
46 St & 28 Ave,40.763328,-73.908782,9,10,19
4 Ave & 17 St,40.665507,-73.993037,8,8,16
46 St & 30 Rd,40.76072,-73.910989,13,8,21
Nostrand Ave & Myrtle Ave,40.69527008,-73.95238108,8,2,10
